80
50
50
../Super_Martin/sprites/tileSet_Snow.png
../Super_Martin/sprites/Background/blue_hills_1.png
../Super_Martin/sound/ezer_ev.mp3
00000000000000000000000000000000000000000000000000000000000000000000000000000000
00000000000000000000000000000000000000000000000000000000000000000000000000000000
00000000000000000000000000000000000000000000000000000000000000000000000000000000
00000000000000000000000000000000000000000000000000000000000000000000000000000000
00000000000000000000000000000000000000000000000000000000000000000000000000000000
00000000000000000000000000N00000000000000000000000000000000000000000000000000000
000000000000000000000000000000000000000000000000000000N0000000000000000000000000
00000000000000000000000000000000000000000000000000000000000000000000000000000000
00000000000000000000000000000000000000000000000000000000000000000000000000000000
00000000000000000000000000000000000000000000000000000000000000000000000000000000
00000000000000000000000000000000000000000000000000000000000000000000000000000000
00000000000000000000000000000000000000000000000000000000000000000000000000N00000
00000000000000000000000000000000000000000000000000000000000000000000000000000000
00000000000000000000000000000000000000000000000000000000000000000000000000000000
00000000000000000000000000000000000000000000000000000000000000000000000000000000
000000000000N0000000000000000000000000000000000000000000000000000000000000000000
00000000000000000000000000000000000000000000000000000000000000000000000000000000
00000000000000000000000000000000000000000000000000000000000000000000000000000000
00000000000000000000000000000000000000000000000000000000000000000000000000000000
00000000000000000000000000000000000000000000000000000000000000000000000000000000
00000000000000000000000000000000000000000000000000000000000000000000000000000000
00000000000000000000000000000000000000000000000000000000000000000000000000000000
00000000000000000000000000000000000000000000000000000000000000000000000000000000
00000000000000000000000000000000000000000000000000000000000000000000000000000000
00000000000000000000000000000000000000000000000000000000000000000000000000000000
00000000000000000000000000000000000000000000000000000000000000000000000000000000
00000000000000000000000000000000000000000000000000000000000000000000000000000000
00000000000000000000000000000000000000000000000000000000000000007700000000000000
00000000000000000000000000000000000000000000000000000000000000007700000000000000
00000000000000000000000000000000000000000000000000000000000000000000000000000000
00000000000000000000000000000000000000000000000000000000000000000000000000000000
00000000000000000000000000000000000000000000000000000000000000P000000E0000000000
00000000000000007777777000000000000000000000000000000000000012222222222222222223
00000000000000007777777000000000000000000000000000000000000045555555555555555556
00000000000000000000000000000000000000000000000000000000000045555555555555555556
00000000000000000000000000000000000000000000000000000000000045555555555555555556
00000000000000000000000000000000000000000000000000000000000045555555555555555556
000000T000P00000000000000000000T0000000000E00000P0000000000045555555555555555556
22222222222222222222222222222222222222222222222222222223000045555555555555555556
55555555555555555555555555555555555555555555555555555556000045555555555555555556
55555555555555555555555555555555555555555555555555555556000045555555555555555556
55555555555555555555555555555555555555555555555555555556000045555555555555555556
55555555555555555555555555555555555555555555555555555556000045555555555555555556
55555555555555555555555555555555555555555555555555555556000045555555555555555556
55555555555555555555555555555555555555555555555555555556000045555555555555555556
00000000000000000000000000000000000000000000000000000000000000000000000000000000
00000000000000000000000000000000000000000000000000000000000000000000000000000000
00000000000000000000000000000000000000000000000000000000000000000000000000000000
00000000000000000000000000000000000000000000000000000000000000000000000000000000
00000000000000000000000000000000000000000000000000000000000000000000000000000000
