138
45
50
../Super_Martin/sprites/tileSet_Snow.png
../Super_Martin/sprites/Background/green_hills_4.png
../Super_Martin/sound/ezer_ev.mp3
000000000000000000000000000000000000000000000000000000000000000000000000000000000000000000000000000000000000000000000000000000000000000000
000000000000000000000000000000000000000000000000000000000000000000000000000000000000000000000000000000000000000000000000000000000000000000
000000000000000000000000000000000000000000000000000000000000000000000000000000000000000000000000000000000000000000000000000000000000000000
000000000000000000000000000000000000000000000000000000000000000000000000000000000000000000000000000000000000000000000000000000000000000000
000000000000000000000000000000000000000000000000000000000000000000000000000000000000000000000000000000000000000000000000000000000000000000
000000000000000000000000000000000000000000000000000000000000000000000000000000000000000000000000000000000000000000000000000000000000000000
000000000000000000000000000000000000000000000000000000000000000000000000000000000000000000000000000000000000000000000000000000000000000000
000000000000000000000000000000000000000000000000000000000000000000000000000000000000000000000000000000000000000000000000000000000000000000
000000000000000000000000000000000000000000000000000000000000000000000000000000000000000000000000000000000000000000000000000000000000000000
000000000000000077700000000000000000000000000000000000000000000000000000000000000000000000000000000000000000000000000000000000000000000000
000000000000000000000000000000000000000000000000000000000000000000000000000000000000000000000000000000000000000000000000000000000000000000
000000000000000000000000000000000000000000000000000000000000000000000000000000000000000000000000000000000000000000000000000000000000000000
000000000000000000000000000000000000000000000000000000000000000000000000000000000000000000000000000000000000000000000000000000000000000000
00000000000000000A000000000000000000000000000000000000000000000000000000000000000000000000000000000000000000000000000000000000000000000000
000000000000000000000000077700000000000000000000000000000000000000000000000000000000000000000000000000000000000000000000000000000000000000
000000000000000000000000000000000000000000000000000000000000000000000000000000000000000000000000000000000000000000000000000000000000000000
000000000000000000000000000090000000000000000000000000000000000000000000000000000000000000000000000000000000000000000000000000000000000000
000000000000000000000000000000000000000000000000000000000000000000000000000000000000000000000000000000000000000000000000000000000000000000
00000000000000000000000000B0000000000000000000B0000B0000000000000000B000000000000000000000000000000000000000000000000000000000000000000000
000000000000000000000000000000000000000000000000000000000000000000000000000000000000000000000000000000000000000000000000000000000000000000
022222222222222200000000000000000000000000000000000000000000000000000000000000000000000000000000000000000000000000000000000000000000000000
000000000000000000000000000000000000000000000000000000000000000000000000000000000000000000000000000000000000000000000000000000000000000000
000000000000000000000000000000000000000000000000000000000000000000000000000000000000000000000000000000000000000000000000000000000000000000
000000000000000000000000000000000000000000000000000000000000000000000000000000000000000000000000000000000000000000000000000000000000000000
000000000000000000000000000000000000000000000000000000000000000000000000000000000000000000000000000000000000B00000000000000000000000000000
000000000000000000000000000000000000000000000000000000000000000000000000000000000000000000000000000000000000000000000000000000000000000000
00000000000000000A000000000000000000000000000000000000000000000000000000000000000000000000000000000000122230000000000000000000000000000000
000000000000000000000000000000000000000000000000000000000000000000000000000000000000000000000000000000455560000000000000000000000000000000
000000000000000000000000000000000000000000000000000000000000000000000000000000000000000000000000000000455560000000000000000000000000000000
000000000000000000000000000000000000000000000000000000000000000000000000000000000000000000000000000000455560000000000000000000000077000000
00000000000000000000000000000000000000000000000000000000000000000000000000000000000000000000000000A000450560000000000000000000000077000000
00000000000000000000000000000P000000000000000008000800000000000000000000000000000000000000000000000000455560000000000000000000000077000000
0000000000000000000000000008888800000000000000880008800000000000000000000000000000000000000000000000004555600000000090E000T00E000000000000
000000000000000000000000000877000000000000000888000888000000000000000000000000000000000000000000000000455560000122222222222222222222222222
000000000000000000000000000877000000000000008887C00788800000000000000000000000000000000000000A00000000455560000455555555555555555555555555
008T0000000000000000E000TP080000008000000008800000000088000000000E00000000000000000P0000E0000000000000455560000455555555555555555555555555
222222222222222222222222222222222222222300122222222222223000000000000002222222222222222222222222222222555560000455555555555555555555555555
555555555555555555555555555555555555555600455555555555555555555555555555555555555550555555555555555555555560000455555555555555555555555555
555555555555555555555555555555555555555600455555555555555555555555555555555555555555555555555555555555555560000455555555552555555555555555
555555555555555555555555555555555555555600455555555555552555555555555555555555555555555555555555555555558560000455555555555555555555555555
555555555855555555555555555555555555555600455555555555555555555555555555555555555555555555555555555505555560000455555555555555555555555555
555555555555555555555555555555555555555600455555555555555555555555555555555555555555555555555555555555555560000455555555555555555558555555
555555555555555555555555555555555555555600455555555555555555555555555555555555555555555555555555555555555560000455555555555555555555555555
555555555555555555555555555555555555555600455555555555555555555555585555555555555555555555555555555555550560000455550555555555555555555555
555555555555555555555555555555555555555600455555555555555555555555555555555555555555555555555555555555555560000455555555555555555555555555
