274
45
54
../Super_Martin/sprites/tileSet_Forest.png
../Super_Martin/sprites/Background/green_hills_4.png
../Super_Martin/sound/ezer_ev.mp3
0000000000000000000000000000000000000000000000000000000000000000000000000000000000000000000000000000000000000000000000000000000000000000000000000000000000000000000000000000000000000000000000000000000000000000000000000000000000000000000000000000000000000000000000000000000000
0000000000000000000000000000000000000000000000000000000000000000000000000000000000000000000000000000000000000000000000000000000000000000000000000000000000000000000000000000000000000000000000000000000000000000000000000000000000000000000000000000000000000000000000000000000000
0000000000000000000000000000000000000000000000000000000000000000000000000000000000000000000000000000000000000000000000000000000000000000000000000000000000000000000000000000000000000000000000000000000000000000000000000000000000000000000000000000000000000000000000000000000000
000000000000000000000000000000000000000000000000000000000000000000000000000000000000000000000000000000000000000000000000000000000000000000000000000000000000000000000000000000000000000000000000000000A000000000000000000000000000000000000000000000000000000000000000000000000000
0000000000000000000000000000000000000000000000000000000000000000000000000000000000000000000000000000000000000000000000000000000000000000000000000000000000000000000000000000000000000000000000000000000000000000000000000000000000000000000000000000000000000000000000000000000000
0000000000000000000000000000000000000000000000000000000000000000000000000000000000000000000000000000000000000000000000000000000000000000000000000000000000000000000000000000000000000000000000000000000000000000000000000000000000000000000000000000000000000000000000000000000000
0000000000000000000000000000000000000000000000000000000000000000000000000000000000000000000000000000000000000000000000000000000000000000000000000000000000000000000000000000000000000000000000000000000000000000000000000000000000000000000000000000000000000000000000000000000000
0000000000000000000000000000000000000000000000000000000000000000000000000000000000000000000000000000000000000000000000000000000000000000000000000000000000000000000000000000000000000000000000000000000000000000000000000000000000000000000000000000000000000000000000000000000000
000000000000000000000000000000000000000000000000000000000000000000000000000000000000000000000000000000000000000000000000000000000000000000000000000000000000000000000000000000000000000000000000000000H000000000000000000000000000000000000000000000000000000000000000000000000000
0000000000000000000000000000000000000000000000000000000000000000000000000000000000000000000000000000000000000000000000000000000000000000000000000000000000000000000000000000000000000000000000000000000000000000000000000000000000000000000000000000000000000000000000000000000000
0000000000000000000000000000000000000000000000000000000000000000000000000000000000000000000000000000000000000000000000000000000000000000000000000000000000000000000000000000000000000000000000000000000000000000000000000000000000000000000000000000000000000000000000000000000000
0000000000000000000000000000000000000000000000000000000000000000000000000000000000000000000000000A00000000000000000000000000000000000000000000000000000000000000000000000000000000000000000000000000000000000000000000000000000000000000000000000000000000000000000000000000000000
0000000000000000000000000000000000000000000000000000000000000000000000000000000000000000000000000000000000000000000000000000000000000000000000000000000000000000000000000000000000000000000000000000000000000000000000000000000000000000000000000000000000000000000000000000000000
0070000000000000000000000000000000000000000000000000000000000000000000000000000000000000000000000000000000000000000000000000000000000000000000000000000000000000000000000000000000000000000000000000000000000000000000000000000000000000000000000000000000000000000000000000000000
0077000000000000000000000000000000000000000000000000000000000000000000000000000000000000000000000000000000E00000000000000000000000000000000000000000000000000000000000000000000000000000000000000000000000000000000000000000000000000000000000000000000000000000000000000000000000
0077700000000000000000000000000000000000000000000000000000000000000000000000000000000000000000000000012222223000000000000000000000000000000000000000000000000000000000000000000000000000000000000000000000000000000000000000000000000000000000000000000000000000000000000000000000
0H77770000000000000000000000000000000000000000000000000000000000000000000000000000000000000000000000045555556000000000000000000000000000000000000000000000000000000000000000000000000000000000000000000000000000000000000000000000000000000000000000000000000000000000000000000000
007777700000000000000000000000000000000000000000000000000000000000000000000000000000000000000C00000004555555600000000000000000000000000000000000000000000000000000000000000000000000000000000000000000C000000000000000000000000000000000000000000000000000000000000000000000000000
0077777770000000000000000000000000000000000000000000000000000000000000000000000000000000000000000000045555556000000000000000000000000000000000000000000000000000000000000000000000000000000000000000000000000000000000000000000000000000000000000000000000000000000000000000000000
0000000000000000000000000000000000000000000000000000000000000000000000000000000000000000000000000A00045555556000000000000000000000000000A00000000000000000000000000000000000000000000000000000000000000000000000000000000000000000000000000000000000000000000000000000000000000000
0000000000000000000000000000000000000000000000000000000000000000000000000000000000000000000122230000045555556000000000000000000000000000000000000000000000000000000000000000000000000000000000000000000000000000000000777770000000000000000000000000000000000000000000000000000000
00A0000000000000000000000000000000000000000000000000000000000000000000000000000000000000000455560000045555556000A0000000000000000000000000000B00000000000B000000000000000000000000000000000000000000000000000000000000077700000000000000000000000000000000000000000000000000000000
0000000000000000000000000000000000000000000000000000000000000000000000000000000000000000000455560000045555556000000000000000000000000000000000000000080080000000000000000000000000000000000000000000000000000000000000077700000000000000000000000000000000000000000000000000000000
0000000000000000000000000000000000000000000000000000000000000000000000000000000000000000000455560000045555556000000000000000000000000000000000000000080080000000000000000000000000000000000000000000000000000000000000000000000000000000000000000000000000000000000000000000000000
00000000000000000000000000000000000000000000000000000000000000000000000000000000000000000004555600000455555560000000000C000000000000000000000000000008008000000N000000000000000000000000000000000000000000000000000001222222300000000000000000000000000000000000000000000000000000
0000000000000000000000000000000000000000000000000000000000000000000000000000000000000122230455560000045555556000000000000000000000000000000000000000080080000000000000000000000000000000000000000000000000000000000004555555600000000000000000000000000000000000000000000000000000
000000000000000000000000000000000000000000000000000000000000000000000000000000000000045556045556000004555555600000000000000000E000000000000000000000080080000000000000000000000000000000000000000000000000000000000004555555600000000000000000000000000000000000000000000000000000
000000000000000000000000000000000000000000000000000000000000000000000000000000000000045556045556000004555555600000000888888888888000000000000000000008008000000000000000000000000000000000000000000000000000000000A004555555600000000000000000000000000000000000000000000000000000
0000000000000000000000000000000000000000000000000000000000000000000000000000000000000455560455560000045555556000000000000000000080000000000000000000080080000000000000000000000000000000000000000000000000000000000004555555600000000000000000000000000000000000000000000000000000
0000000000000000000000000C00000000000000000000000000000000000000000000000E00P0000000045556045556000004555555600000000000000000H08000000000000000000008008000000000000000000000000000000000000000000000A000000000000004555555600000000000000000000000000000000000000000000000000000
000000000000000000000000000000000000000000000000000000000000000001222222222222222223045556045556000004555555600000000000000000778000000000000000000088008800000000000000000000000000000000000000000000000000000000A004555555600000000000000000000000000000000000000000000000000000
00000000000000000000000000000000000000000000000000000000000000000455555555555555555604555604555600000455555560000000000000000077800000000000000000088800888000000000000000000000000000000000000000000000000000E00000045555556000E000000000000000000000000000000000000E000000000000
00000B0000000000E0B00000000000E0000P00000000000000000000000000045555555555555555560455560455560000045555556000A00000000000E0008000000000000000008800000088000000000000000000000000000000000000122222222222222222222222222222222222222222222300000000000000000088888888880000000000
00000000000122222222222222222222222222222230000000000E00P0000000045555555555555555560455560455560000045555556000000012222222222230000000000000009887700007788000000000000000000000000000000000004555555555555555555555555555555555555555555556000000000000000000888888888800000000
000C000000045555555555555555555555555555556000122222222222222300045555555555555555560455560455560000045555556000000045555555555560000000000000008807700007708800000000000000000000000000000000004555555555555555555555555555555555555555555556000000000000000000888888888800000000
0000000000045555555555555555555555555555556000455555555555555600045555555555555555560455560455560000045555556000000045555555555560000000000000088L00000000C00880000000000000000000000000000000004555555555555555555555555555555555555555555556000000000000000000887777778800000000
00A0000000045555555555555555555555555555556000455555555555555600045555555555555555560455560455560000045555556000000045555555555560000700000000880000000000000088000000000000000000000000000000004555555555555555555555555555555555555555555556000000000000000E0088777H778800000000
0000000000045555555555555555555555555555556000455555555555555600045555555555555555560455560455560000045555556000000045555555555560000700A00008880000000000000088800000000000000000000000000000004555555555555555555555555555555555555555555556000000008888888888880000000000000000
1222222222255555555555555555555555555555556000455555555555555600045555555555555555560455560455560000045555556000000045555555555560000000000088880E000000000E0088880000T000000000000P000009P000004555555555555555555555555555555555555555555556000000008888888888880000000000000000
455555555555555555555555555555555555555555600045555555555555560004555555555555555556045556045556000004555555600000004555555555556001222222222222222222222222222222222222222222222222222222230000455555555555555555555555555555555555555555555600000088888888888888000000000A000000
4555555555555555555555555555555555555555556000455555555555555600045555555555555555560455560455560000045555556000000045555555555560045555555555555555555555555555555555555555555555555555555600004555555555555555555555555555555555555555555556000000888888888888888888000000000000
4555555555555555555555555555555555555555556000455555555555555600045555555555555555560455560455560000045555556000000045555555555560045555555555555555555555555555555555555555555555555555555600004555555555555555555555555555555555555555555556000122222222222222222222222222222222
4555555555555555555555555555555555555555556000455555555555555600045555555555555555560455560455560000045555556000000045555555555560045555555555555555555555555555555555555555555555555555555600004555555555555555555555555555555555555555555556000455555555555555555555555555555555
4555555555555555555555555555555555555555556000455555555555555600045555555555555555560455560455560000045555556000000045555555555560045555555555555555555555555555555555555555555555555555555600004555555555555555555555555555555555555555555556000455555555555555555555555555555555
4555555555555555555555555555555555555555556000455555555555555600045555555555555555560455560455560000045555556000000045555555555560045555555555555555555555555555555555555555555555555555555600004555555555555555555555555555555555555555555556000455555555555555555555555555555555
