285
45
57
../Super_Martin/sprites/tileSet_Forest.png
../Super_Martin/sprites/Background/green_hills_4.png
../Super_Martin/sound/ezer_ev.mp3
000000000000000000000000000000000000000000000000000000000000000000000000000000000000000000000000000000000000000000000000000000000000000000000000000000000000000000000000000000000000000000000000000000000000000000000000000000000000000000000000000000000000000000000000000000000000000000000
000000000000000000000000000000000000000000000000000000000000000000000000000000000000000000000000000000000000000000000000000000000000000000000000000000000000000000000000000000000000000000000000000000000000000000000000000000000000000000000000000000000000000000000000000000000000000000000
000000000000000000000000000000000000000000000000000000000000000000000000000000000000000000000000000000000000000000000000000000000000000000000000000000000000000000000000000000000000000000000000000000000000000000000000000000000000000000000000000000000000000000000000000000000000000000000
000000000000000000000000000000000000000000000000000000000000000000000000000000000000000000000000000000000000000000000000000000000000000000000000000000000000000000000000000000000000000000000000000000A00000000000000000000000000000000000000000000000000000000000000000000000000000000000000
000000000000000000000000000000000000000000000000000000000000000000000000000000000000000000000000000000000000000000000000000000000000000000000000000000000000000000000000000000000000000000000000000000000000000000000000000000000000000000000000000000000000000000000000000000000000000000000
000000000000000000000000000000000000000000000000000000000000000000000000000000000000000000000000000000000000000000000000000000000000000000000000000000000000000000000000000000000000000000000000000000000000000000000000000000000000000000000000000000000000000000000000000000000000000000000
000000000000000000000000000000000000000000000000000000000000000000000000000000000000000000000000000000000000000000000000000000000000000000000000000000000000000000000000000000000000000000000000000000000000000000000000000000000000000000000000000000000000000000000000000000000000000000000
000000000000000000000000000000000000000000000000000000000000000000000000000000000000000000000000000000000000000000000000000000000000000000000000000000000000000000000000000000000000000000000000000000000000000000000000000000000000000000000000000000000000000000000000000000000000000000000
000000000000000000000000000000000000000000000000000000000000000000000000000000000000000000000000000000000000000000000000000000000000000000000000000000000000000000000000000000000000000000000000000000H00000000000000000000000000000000000000000000000000000000000000000000000000000000000000
000000000000000000000000000000000000000000000000000000000000000000000000000000000000000000000000000000000000000000000000000000000000000000000000000000000000000000000000000000000000000000000000000000000000000000000000000000000000000000000000000000000000000000000000000000000000000000000
000000000000000000000000000000000000000000000000000000000000000000000000000000000000000000000000000000000000000000000000000000000000000000000000000000000000000000000000000000000000000000000000000000000000000000000000000000000000000000000000000000000000000000000000000000000000000000000
0000000000000000000000000000000000000000000000000000000000000000000000000000000000000000000000000A0000000000000000000000000000000000000000000000000000000000000000000000000000000000000000000000000000000000000000000000000000000000000000000000000000000000000000000000000000000000000000000
000000000000000000000000000000000000000000000000000000000000000000000000000000000000000000000000000000000000000000000000000000000000000000000000000000000000000000000000000000000000000000000000000000000000000000000000000000000000000000000000000000000000000000000000000000000000000000000
007000000000000000000000000000000000000000000000000000000000000000000000000000000000000000000000000000000000000000000000000000000000000000000000000000000000000000000000000000000000000000000000000000000000000000000000000000000000000000000000000000000000000000000000000000000000000000000
0077000000000000000000000000000000000000000000000000000000000000000000000000000000000000000000000000000000E0000000000000000000000000000000000000000000000000000000000000000000000000000000000000000000000000000000000000000000000000000000000000000000000000000000000000000000000000000000000
007770000000000000000000000000000000000000000000000000000000000000000000000000000000000000000000000001222222300000000000000000000000000000000000000000000000000000000000000000000000000000000000000000000000000000000000000000000000000000000000000000000000000000000000000000000000000000000
0H7777000000000000000000000000000000000000000000000000000000000000000000000000000000000000000000000004555555600000000000000000000000000000000000000000000000000000000000000000000000000000000000000000000000000000000000000000000000000000000000000000000000000000000000000000000000000000000
007777700000000000000000000000000000000000000000000000000000000000000000000000000000000000000C00000004555555600000000000000000000000000000000000000000000000000000000000000000000000000000000000000000C00000000000000000000000000000000000000000000000000000000000000000000000000000000000000
007777777000000000000000000000000000000000000000000000000000000000000000000000000000000000000000000004555555600000000000000000000000000000000000000000000000000000000000000000000000000000000000000000000000000000000000000000000000000000000000000000000000000000000000000000000000000000000
0000000000000000000000000000000000000000000000000000000000000000000000000000000000000000000000000A00045555556000000000000000000000000000A0000000000000000000000000000000000000000000000000000000000000000000000000000000000000000000000000000000000000000000000000000000000000000000000000000
000000000000000000000000000000000000000000000000000000000000000000000000000000000000000000012223000004555555600000000000000000000000000000000000000000000000000000000000000000000000000000000000000000000000000000000077777000000000000000000000000000000000000000000000000000000000000000000
00A000000000000000000000000000000000000000000000000000000000000000000000000000000000000000045556000004555555600000000000000000000000000000000B00000000000B00000000000000000000000000000000000000000000000000000000000007770000000000000000000000000000000000000000000000000000000000000000000
0000000000000000000000000000000000000000000000000000000000000000000000000000000000000000000455560000045555556000A0000000000000000000000000000000000008008000000000000000000000000000000000000000000000000000000000000007770000000000000000000000000000000000000000000000000000000000000000000
000000000000000000000000000000000000000000000000000000000000000000000000000000000000000000045556000004555555600000000000000000000000000000000000000008008000000000000000000000000000000000000000000000000000000000000000000000000000000000000000000000000000000000000000000000000000000000000
00000000000000000000000000000000000000000000000000000000000000000000000000000000000000000004555600000455555560000000000C000000000000000000000000000008008000000N00000000000000000000000000000000000000000000000000000122222230000000000000000000000000000000000000000000000000000000000000000
000000000000000000000000000000000000000000000000000000000000000000000000000000000000012223045556000004555555600000000000000000000000000000000000000008008000000000000000000000000000000000000000000000000000000000000455555560000000000000000000000000000000000000000000000000000000000000000
000000000000000000000000000000000000000000000000000000000000000000000000000000000000045556045556000004555555600000000000000000E00000000000000000000008008000000000000000000000000000000000000000000000000000000000000455555560000000000000000000000000000000000000000000000000000000000000000
000000000000000000000000000000000000000000000000000000000000000000000000000000000000045556045556000004555555600000000888888888888000000000000000000008008000000000000000000000000000000000000000000000000000000000A00455555560000000000000000000000000000000000000000000000000000000000000000
000000000000000000000000000000000000000000000000000000000000000000000000000000000000045556045556000004555555600000000000000000008000000000000000000008008000000000000000000000000000000000000000000000000000000000000455555560000000000000000000000000000000000000000000000000000000000000000
0000000000000000000000000C00000000000000000000000000000000000000000000000E00P0000000045556045556000004555555600000000000000000H08000000000000000000008008000000000000000000000000000000000000000000000A00000000000000455555560000000000000000000000000000000000000000000000000000000000000000
00000000000000000000000000000000000000000000000000000000000000001222222222222222223045556045556000004555555600000000000000000778000000000000000000088008800000000000000000000000000000000000000000000000000000000A0045555556000000000000000D0000000000000000000000000000000000000000000000000
00000B0000000000000000000000000000000000000000000000000000B000000455555555555555555604555604555600000455555560000000000000000077800000000000000000888800888000000000000000000000000000000000000000000000000000E00000045555556000E000000000000000000000000000000000000E00000A00000000000000000
0000000000000000E0000000000000E0000P00000000000000000000000000000455555555555555555604555604555600000455555560000000000000E000008000000000000000088000008888000000000000000000000000000000000000122222222222222222222222222222222222222222222300000000000000000088888888880000000000000000000
00000000000122222222222222222222222222222230000000000E00P0000000045555555555555555560455560455560000045555556000A0001222222222223000000000000000988770000778800000000000000000000000000000000000455555555555555555555555555555555555555555555600000000000000000088888888880000000000000000000
000C00000004555555555555555555555555555555600012222222222222230004555555555555555556045556045556000004555555600000004555555555556000000000000000880770000770880000000000000000000000000000000000455555555555555555555555555555555555555555555600000000000000000088888888880000000000000000000
0000000000045555555555555555555555555555556000455555555555555600045555555555555555560455560455560000045555556000000045555555555560000000000000088L00000000C0088000000000000000000000000000000000455555555555555555555555555555555555555555555600000000000000000088777777880000000000000000000
00A0000000045555555555555555555555555555556000455555555555555600045555555555555555560455560455560000045555556000000045555555555560000700000000880000000000000088000000000000000000000000000000004555555555555555555555555555555555555555555556000000000000000E0088777H77880000000000000000000
0000000000045555555555555555555555555555556000455555555555555600045555555555555555560455560455560000045555556000000045555555555560000700A0000888000000000000008880000000000000000D00000000000000455555555555555555555555555555555555555555555600000000888888888888000000000000000000000000000
1222222222255555555555555555555555555555556000455555555555555600045555555555555555560455560455560000045555556000000045555555555560000000000088880E000000000E0088880000T000000000000P000009P00000455555555555555555555555555555555555555555555600000000888888888888000000000000000000000000000
455555555555555555555555555555555555555555600045555555555555560004555555555555555556045556045556000004555555600000004555555555556001222222222222222222222222222222222222222222222222222222230000455555555555555555555555555555555555555555555600000088888888888888000000000A0000000000000D000
455555555555555555555555555555555555555555600045555555555555560004555555555555555556045556045556000004555555600000004555555555556004555555555555555555555555555555555555555555555555555555560000455555555555555555555555555555555555555555555600000088888888888888888800000000000000000000000
455555555555555555555555555555555555555555600045555555555555560004555555555555555556045556045556000004555555600000004555555555556004555555555555555555555555555555555555555555555555555555560000455555555555555555555555555555555555555555555600012222222222222222222222222222222222222222223
455555555555555555555555555555555555555555600045555555555555560004555555555555555556045556045556000004555555600000004555555555556004555555555555555555555555555555555555555555555555555555560000455555555555555555555555555555555555555555555600045555555555555555555555555555555555555555556
455555555555555555555555555555555555555555600045555555555555560004555555555555555556045556045556000004555555600000004555555555556004555555555555555555555555555555555555555555555555555555560000455555555555555555555555555555555555555555555600045555555555555555555555555555555555555555556
455555555555555555555555555555555555555555600045555555555555560004555555555555555556045556045556000004555555600000004555555555556004555555555555555555555555555555555555555555555555555555560000455555555555555555555555555555555555555555555600045555555555555555555555555555555555555555556
