400
45
50
../Super_Martin/sprites/tileSet_Beach.png
../Super_Martin/sprites/Background/green_hills_4.png
../Super_Martin/sound/ezer_ev.mp3
0000000000000000000000000000000000000000000000000000000000000000000000000000000000000000000000000000000000000000000000000000000000000000000000000000000000000000000000000000000000000000000000000000000000000000000000000000000000000000000000000000000000000000000000000000000000000000000000000000000000000000000000000000000000000000000000000000000000000000000000000000000000000000000000000000000000000000
0000000000000000000000000000000000000000000000000000000000000000000000000000000000000000000000000000777700000000000000000000000000000000000000000000000000000000000000000000000000000000000000000000000000000000000000000000000000000000000000000000000000000000000000000000000000000000000000000000000000000000000000000000000000000000000000000000000000000000000000000000000000000000000000000000000000000000
0000000000000000000000000000000000000000000000000000000000000000000000000000000000000000000000000000000700000000000000000000000000000000000000000000000000000000000000000000000000000000000000000000000000000000000000000000000000000000000000000000000000000000000000000000000000000000000000000000000000000000000000000000000000000000000000000000000000000000000000000000000000000000000000000000000000000000
0000000000000000000000000000000000000000000000000000000000000000000000000000000000000000000000000000000770000000000000000000000000000000000000000000000000000000000000000000000000000000000000000000000000000000000000000000000000000000000000000000000000000000000000000000000000000000000000000000000000000000000000000000000000000000000000000000000000000000000000000000000000000000000000000000000000000000
000000000000000000000000000000000000000000000000000000000000000000000000000000000000000000000000000B000070000000000000000000000000000000000000000000000000000000000000000000000000000000000000000000000000000000000000000000000000000000000000000000000000000000000000000000000000000000000000000000000000000000000000000000000000000000000000000000000000000000000000000000000000000000000000000000000000000000
0000000000000000000000000000000000000000000000000000000000000000000000000000000000000000000000000000000070000000000000000000000000000000000000000000000000000000000000000000000000000000000000000000000000000000000000000000000000000000000000000000000000000000000000000000000000000000000000000000000000000000000000000000000000000000000000000000000000000000000000000000000000000000000000000000000000000000
0000000000000000000000000000000000000000000000000000000000000000000000000000000000000000000000000000000070000000000000000000000000000000000000000000000000000000000000000000000000000000000000000000000000000000000000000000000000000000000000000000000000000000000000000000000000000000000000000000000000000000000000000000000000000000000000000000000000000000000000000000000000000000000000000000000000000000
0000000000000000000000000000000000000000000000000000000000000000000000000000000000000000000000000000000000000000000000000000000000000000000000000000000000000000000000000000000000000000000000000000000000000000000000000000000000000000000000000000000000000000000000000000000000000000000000000000000000000000000000000000000000000000000000000000000000000000000000000000000000000000000000000000000000000000
0000000000000000000000000000000000000000000000000000000000000000000000000000000000000000000000000000000000000000000000000000000000000000000000000000000000000000000000000000000000000000000000000000000000000000000000000000000000000000000000000000000000000000000000000000000000000000000000000000000000000000000000000000000000000000000000000000000000000000000000000000000000000000000000000000000000000000
000000000000000000000000000000000000000000000000000000000000000000000000000000000000000000000000000000000E000000000000000000000000000000000000000000000000000000000000000000000000000000000000000000000000000000000000000000000000000000000000000000000000000000000000000000000000000000000000000000000000000000000000000000000000000000000000000000000000000000000000000000000000000000000000000000000000000000
0000000000000000000000000000000000000000000000000000000000000000000000000000000000000000000000000000122222230000000000000000000000000000000000000000000000000000000000000000000000000000000000000000000000000000000000000000000000000000000000000000000000000000000000000000000000000000000000000000000000000000000000000000000000000000000000000000000000000000000000000000000000000000000000000000000000000000
00777000000000000000000000000000000000000000000000000000000000000000000000000000000000000000C0000000455555560000000000000000000000000000000000000000000000000000000000000000000000000000000000000000000000000000000000000000000000000000000000000000000000000000000000000000000000000000000000000000000000000000000000000000000000000000000000000000000000000000000000000000000000000000000000000000000000000000
0000000000000000000000000000000000000000000000000000000000000000000000000000000000000000000000000000455555560000000000000000000000000000000000000000000000000000000000000000000000000000000000000000000000000000000000000000000000000000000000000000000000000000000000000000000000000000000000000000000000000000000000000000000000000000000000000000000000000000000000000000000000000000000000000000000000000000
0000000000000000000000000000000000000000000000000000000000000000000000000000000000000000000000000000455555560000000000000000000000000000000000000000000000000000000000000000000000000000000000000000000000000000000000000000000000000000000000000000000000000000000000000000000000000000000000000000000000000000000000000000000000000000000000000000000000000000000000000000000000000000000000000000000000000000
000A000000000000000000000000000000000000000000000000000000000000000000000000000000000000001222300000455555560000000000000000000000000000000000000000000000000000000000000000000000000000000000000000000000000000000000000000000000000000000000000000000000000000000000000000000000000000000000000000000000000000000000000000000000000000000000000000000000000000000000000000000000000000000000000000000000000000
0000000000000000000000000000000000000000000000000000000000000000000000000000000000000000004555600000455555560000000000000000000000000000000000000000000000000000000000000000000000000000000000000000000000000000000000000000000000000000000000000000000000000000000000000000000000000000000000000000000000000000000000000000000000000000000000000000000000000000000000000000000000000000000000000000000000000000
0000000000000000000000000000000000000000000000000000000000000000000000000000000000000000004555600A00455555560000000000000000000000000000000000000000000000000000000000000000000000000000000000000000000000000000000000000000000000000000000000000000000000000000000000000000000000000000000000000000000000000000000000000000000000000000000000000000000000000000000000000000000000000000000000000000000000000000
0ÚÐÁsÐÐPÛþÒÐÐÐÐÐÐÐÐÐÐÐÐÐÐÐÐÐÐÐÐÐÐÐÐÿÿÿÿÿÿÐÐÐÐÐÐÐÐÐÐÐÐÿÿÿÿÿÿÐÐÐÐÐÐÐÐÐÐÐÐÿÿÿÿÿÿÐÐÐÐÐÐÐÐÐÐÐÐ45556ÿÐÐÐÐ45555556ÿÿÿÿÿÿ0ÐÐÐÐÐÐÐÐÐÐÐÿÿÿÿÿÿÐÐÐÐÐÐÐÐÐÐÐÐÿÿÿÿÿÿÐÐÐÐÐÐÐÐÐÐÐÐÿÿÿÿÿÿÐÐÐÐÐÐÐÐÐÐÐÐÿÿÿÿÿÿÿÿÿÿÿÿÿÿÿÿÿÐÿÿÿÿÿÿÿÿÿÿÿÿÿÿÿÿÿÐÿÿÿÿÿÿÿÿÿÿÿÿÿÿÿÿÿÐÿÿÿÿÿÿÿÿÿÿÿÿÿÿÿÿÿÐÿÿÿÿÿÿÿÿÿÿÿÿÿÿÿÿÿÐÿÿÿÿÿÿÐÐÐÐÐÐÐÐÐÐÐÐÿÿÿÿÿÿÐÐÐÐÐÐÐÐÐÐÐÐÿÿÿÿÿÿÐÐÐÐÐÐÐÐÐÐÐÐÿÿÿÿÿÿÐÐÐÐÐÐÐÐÐÐÐÐÿÿÿÿÿÿÐÐÐÐÐÐÐÐÐÐÐÐÿÿÿÿÿÿÐÐÐÐÐÐÐÐÐÐÐÐÿÿÿÿÿÿÐÐÐÐÐÐÐÐÐÐÐÐÿÿÿÿ
0000000000000000000000000000777700000000000000000000077700000000000000000000000000000000004555600000455555560A0000000000000000000000000000000000000000000000000000000000000000000000000000000000000000000000000000000000000000000000000000000000000000000000000000000000000000000000000000000000000000000000000000000000000000000000000000000000000000000000000000000000000000000000000000000000000000000000000Ú
000000000000000000000000000000000000000000000000000000000000000000000000000000000000000000455560000045555556000000000000000000000000000000000000000000000000000000000000000000000000000000000000000000000000000000000000000000000000000000000000000000000000000000000000000000000000000000000000000000000000000000000000000000000000000000000000000000000000000000000000000000000000000000000000000000000000000Ú
000000000000000000000000000000000000000000000000000000000000000000000000000000000000122230455560000045555556000000000000000000000000000000000000000000000000000000000000000000000000000000000000000000000000000000000000000000000000000000000000000000000000000000000000000000000000000000000000000000000000000000000000000000000000000000000000000000000000000000000000000000000000000000000000000000000000000Ú
00000000000000000000000000000B000000000000000000000000B000000000000000000000000000004555604555600000455555560000000000000090E0T00000000000000000000000000000000000000000000000000000000000000000000000000000000000000000000000000000000000000000000000000000000000000000000000000000000000000000000000000000000000000000000000000000000000000000000000000000000000000000000000000000000000000000000000000000000Ú
000000000000000000000000000000000000000000000000000000000000000000000000C00000000000455560455560000045555556000000008888888888880000000000000000000000000000000000000000000000000000000000000000000000000000000000000000000000000000000000000000000000000000000000000000000000000000000000000000000000000000000000000000000000000000000000000000000000000000000000000000000000000000000000000000000000000000000Ú
000000000000000000000000000000000000000000000000000000000000000000000000000000000000455560455560000045555556000A00000000000000080000000000000000000000000000000000000000000000000000000000000000000000000000000000000000000000000000000000000000000000000000000000000000000000000000000000000000000000000000000000000000000000000000000000000000000000000000000000000000000000000000000000000000000000000000000Ú
00000000000000000000000000000000000000000000000000000000000000000000000000000E0000904555604555600000455555560000000000000000000800000000000000000000000000000000000000000000000000000000000000000000000000000000000000000000000000000000000000000000000000000000000000000000000000000000000000000000000000000000000000000000000000000000000000000000000000000000000000000000000000000000000000000000000000000000
000C000000000000000000000000000000000000000000000000000000000000122222222222222222304555604555600000455555560000000000000000077800000000000000000000000000000000000000000000000000000000000B00000000000000000000000000000000000000000000000000000000000000000000000000000000000000000000000000000000000000000000000000000000000000000000000000000000000000000000000000000000000000000000000000000000000000000000
0000000000000000000000000000000000000000000000000000000000000000455555555555555555604555604555600000455555560000000000000000077800000000000000000000000000000000000000000000000000000000000000000000000000000000000000000000000000000000000000000000000000000000000000000000000000000000000000000000000000000000000000000000000000000000000000000000000000000000000000000000000000000000000000000000000000000000
0000000000000000E0000000090000T00E0000000000000000000000000000004555555555555555556045556045556000004555555600000000000000E0000800000000000000000000000000000000000000000000000000000000000000000000000000000000000000000000000000000000000000000000000000000000000000000000000000000000000000000000000000000000000000000000000000000000000000000000000000000000000000000000000000000000000000000000000000000000
000000000012222222222222222222222222222223000000P0000000000E0000455555555555555555604555604555600000455555560000000122222222222300000000000000000000000000000000000000000000000000000000000000000000000000000000000000000000000000000000000000000000000000000000000000000000000000000000000000000000000000000000000000000000000000000000000000000000000000000000000000000000000000000044444444444444444444444444
000A000000455555555555555555555555555555560001222222222222222300455555555555555555604555604555600000455555560000000455555555555600000000000000000000000000000000000000000000000000000000000000000000000000000000000000000000000000000000000000000000000000000000000000000000000000000000000000000000000000000000000000000000000000000000000000000000000000000000000000000000000000000000000000000000000000000000
0ÚÐÁsÐÐxw45555555555555555555555555555556ÐÐÐ45555555555555556ÐÐ4555555555555555556Ð45556Ð45556ÿÿÿÿÿ45555556ÐÐÐÐÿÿ04555555555556xw©ÁsÐÐp¸ÒÐÐÐÐÐÐÐÐÐÐÐCÐÐÐÐÐÐÐÐÐÐÐÐÐÐÐÐÐÐÐÐÐÐÐ¾ÑÐÐÐÐÐÐÐÐÐÐÐÐÐÐÐÐÐÐÐÐÐÐåÒÐÐÐÐÐÐÐÐÐÐÐÐÐÐýþÿÿÿÿÿÿÐÐÐÐÐÐÐÐÐÐÐÐÐÐÐÐÐÐÐÐÐÐÐÐÐÐÐÐÐÐÐÐÐÐÐÐÐÐÐÐÐÐÐÐÐÐÐÐÐÐÐÐÐÐÐÐÐÐÐÐÐÐÐÐÐÐÐÐÐÐÐÐÐÐÐÐÐÐÐÐÐÐÐÐÐÐÐÐÐÐÐÐÐÐÐÐ×¸ÿÀ16ÚØÑáÐÐÐÐÐÐÐHx©ÁsÐÐHx©ÁsÐÐïéÿé15éÓãðØÐMÜÒÝ¸ÿÀ16àÝèHÝéOéÑÓçåªèÜÙ¸ÿø16éáâÐLÙˆÝ
0000000000455555555555555555555555555555560004555555555555555600455555555555555555604555604555600000455555560A0000045555555555560000000000000000000000000000000000000000000000000000000000000000000000000000000000000000000000000000000000000000000000000000000000000000000000000000000000000000000000000000000000000000000000000000000000000000000000000000000000000000000000000000000000000000000000000000000Ú
000000000045555555555555555555555555555556000455555555555555560045555555555555555560455560455560000045555556000000045555555555560000000000000000000000000000000000000000000000000000000000000000000000000000000000000000000000000000000000000000000000000000000000000000000000000000000000000000000000000000000000000000000000000000000000000000000000000000000000000000000000000000000000000000000000000000000Ú
90000000P045555555555555555555555555555556000455555555555555560045555555555555555560455560455560000045555556000000045555555555560000000000000000000000000000000000000000000000000000000000000000000000000000000000000000000000000000000000000000000000000000000000000000000000000000000000000000000000000000000000000000000000000000000000000000000000000000000000000000000000000000000000000000000000000000000Ú
222222222255555555555555555555555555555556000455555555555555560045555555555555555560455560455560000045555556000000045555555555560000000000000000000000000000000000000000000000000000000000000000000000000000000000000000000000000000000000000000000000000000000000000000000000000000000000000000000000000000000000000000000000000000000000000000000000000000000000000000000000000000000000000000000000000000000Ú
555555555555555555555555555555555555555556000455555555555555560045555555555555555560455560455560000045555556000000045555555555560000000000000000000000000000000000000000000000000000000000000000000000000000000000000000000000000000000000000000000000000000000000000000000000000000000000000000000000000000000000000000000000000000000000000000000000000000000000000000000000000000000000000000000000000000000Ú
555555555555555555555555555555555555555556000455555555555555560045555555555555555560455560455560000045555556000000045555555555560012222222300000000000000000000000000000000000000000000000000000000000000000000000000000000000000000000000000000000000000000000000000000000000000000000000000000000000000000000000000000000000000000000000000000000000000000000000000000000000000000000000000000000000000000000Ú
555555555555555555555555555555555555555556000455555555555555560045555555555555555560455560455560000045555556000000045555555555560045555555600000000000000000000000000000000000000000000000000000000000000000000000000000000000000000000000000000000000000000000000000000000000000000000000000000000000000000000000000000000000000000000000000000000000000000000000000000000000000000000000000000000000000000000Ú
555555555555555555555555555555555555555556000455555555555555560045555555555555555560455560455560000045555556000000045555555555560045555555600000000000000000000000000000000000000000000000000000000000000000000000000000000000000000000000000000000000000000000000000000000000000000000000000000000000000000000000000000000000000000000000000000000000000000000000000000000000000000000000000000000000000000000Ú
555555555555555555555555555555555555555556000455555555555555560045555555555555555560455560455560000045555556000000045555555555560045555555600000000000000000000000000000000000000000000000000000000000000000000000000000000000000000000000000000000000000000000000000000000000000000000000000000000000000000000000000000000000000000000000000000000000000000000000000000000000000000000000000000000000000000000Ú
555555555555555555555555555555555555555556000455555555555555560045555555555555555560455560455560000045555556000000045555555555560045555555600000000000000000000000000000000000000000000000000000000000000000000000000000000000000000000000000000000000000000000000000000000000000000000000000000000000000000000000000000000000000000000000000000000000000000000000000000000000000000000000000000000000000000000Ú
555555555555555555555555555555555555555556000455555555555555560045555555555555555560455560455560000045555556000000045555555555560045555555600000000000000000000000000000000000000000000000000000000000000000000000000000000000000000000000000000000000000000000000000000000000000000000000000000000000000000000000000000000000000000000000000000000000000000000000000000000000000000000000000000000000000000000Ú
555555555555555555555555555555555555555556000455555555555555560045555555555555555560455560455560000045555556000000045555555555560045555555600000000000000000000000000000000000000000000000000000000000000000000000000000000000000000000000000000000000000000000000000000000000000000000000000000000000000000000000000000000000000000000000000000000000000000000000000000000000000000000000000000000000000000000Ú
555555555555555555555555555555555555555556000455555555555555560045555555555555555560455560455560000045555556000000045555555555560045555555600000000000000000000000000000000000000000000000000000000000000000000000000000000000000000000000000000000000000000000000000000000000000000000000000000000000000000000000000000000000000000000000000000000000000000000000000000000000000000000000000000000000000000000Ú
555555555555555555555555555555555555555556000455555555555555560045555555555555555560455560455560000045555556000000045555555555560045555555600000000000000000000000000000000000000000000000000000000000000000000000000000000000000000000000000000000000000000000000000000000000000000000000000000000000000000000000000000000000000000000000000000000000000000000000000000000000000000000000000000000000000000000Ú
