160
45
50
../Super_Martin/sprites/tileSet_Snow.png
../Super_Martin/sprites/Background/green_hills_4.png
../Super_Martin/sound/ezer_ev.mp3
0000000000000000000000000000000000000000000000000000000000000000000000000000000000000000000000000000000000000000000000000000000000000000000000000000000000000000
0000000000000000000000000000000000000000000000000000000000000000000000000000000000000000000000000000000000000000000000000000000000000000000000000000000000000000
0000000000000000000000000000000000000000000000000000000000000000000000000000000000000000000000000000000000000000000000000000000000000000000000000000000000000000
0000000000000000000000000000000000000000000000000000000000000000000000000000000000000000000000000000000000000000000000000000000000000000000000000000000000000000
0000000000000000000000000000000000000000000000000000000000000000000000000000000000000000000000000000000000000000000000000000000000000000000000000000000000000000
0000000000000000000000000000000000000000000000000000000000000000000000000000000000000000000000000000000000000000000000000000000000000000000000000000000000000000
0000000000000000000000000000000000000000000000000000000000000000000000000000000000000000000000000000000000000000000000000000000000000000000000000000000000000000
0000000000000000000000000000000000000000000000000000000000000000000000000000000000000000000000000000000000000000000000000000000000000000000000000000000000000000
0000000000000000000000000000000000000000000000000000000000000000000000000000000000000000000000000000000000000000000000000000000000000000000000000000000000000000
0000000000000000000000000000000000000000000000000000000000000000000000000000000000000000000000000000000000000000000000000000000000000000000000000000000000000000
0000000000000000000000000000000000000000000000000000000000000000000000000000000000000000000000000000000000000000000000000000000000000000000000000000000000000000
0000000000000000000000000000000000000000000000000000000000000000000000000000000000000000000000000000000000000000000000000000000000000000000000000000000000000000
0000000000000000000000000000000000000000000000000000000000000000000000000000000000000000000000000000000000000000000000000000000000000000000000000000000000000000
0000000000000000000000000000000000000000000000000000000000000000000000000000000000000000000000000000000000000000000000000000000000000000000000000000000000000000
0000000000000000000000000000000000000000000000000000000000000000000000000000000000000000000000000000000000000000000000000000000000000000000000000000000000000000
0000000000000000000000000000000000000000000000000000000000000000000000000000000000000000000000000000000000000000000000000000000000000000000000000000000000000000
0000000000000000000000000000000000000000000000000000000000000000000000000000000000000000000000000000000000000000000000000000000000000000000000000000000000000000
0000000000000000000000000000000000000000000000000000000000000000000000000000000000000000000000000000000000000000000000000000000000000000000000000000000000000000
0000000000000000000000000000000000000000000000000000000000000000000000000000000000000000000000000000000000000000000000000000000000000000000000000000000000000000
0000000000000000000000000000000000000000000000000000000000000000000000000000000000000000000000000000000000000000000000000000000000000000000000000000000000000000
0000000000000000000000000000000000000000000000000000000000000000000000000000000000000000000000000000000000000000000000000000000000000000000000000000000000000000
0000000000000000000000000000000000000000000000000000000000000000000000000000000000000000000000000000000000000000000000000000000000000000000000000000000000000000
0000000000000000000000000000000000000000000000000000000000000000000000000000000000000000000000000000000000000000000000000000000000000000000000000000000000000000
0000000000000000000000000000000000000000000000000000000000000000000000000000000000000000000000000000000000000000000000000000000000000000000000000000000000000000
0000000000000000000000000000000000000000000000000000000000000000000000000000000000000000000000000000000000000000000000000000000000000000000000000000000077770000
000000000000000000000000000000000000000000000000000000000000000000000000000000000000000000000000000000000000000000000000000000000000000000000000000000161670000000
00000000000000000000000000000000000B0000000B00000000000000000000000000B00000000000000000000000000000000000000000000000000000000000000000000000000000001616716770000
0000000000000000000000000000000000000000000000000000000000000000000000000000000000000000000000000000000000000000000000000000000000000000000000000000000070070000
000000000000000000000000000000000000000000000000000000007777000A000000000000000000000000000000000000000000000000000000000000000000000000000000000000000077770000
0000000000000000000000000000000900000000000000000000000000000000000000000000000000000000000000000000000000000000000000000000000000000000000000000000000000070000
0000000000000000000000161688800888816000000000000000000000000000000000000000000000000000000000000000000000000000000000000000000000000000000000000000000001222222223
000000000000000000000161688800000888000000000000000000000000000000000000000000000000000000000000000000000000000000000000000000000000000000000000000000004555555556
0000000000000000000001688870000078881600000000000000000000000E0000000000000000000000000000000000000000000000000000000000000000000000000000000000000000004555555556
000000000000000000001688870000000788816000000000000000000122222300000000000000000000000000000000000000000000000000000000000000000000000000000000000000004555555556
00000001600000000000088870000000007888161616161616161616161616161616161616455555600000000000000000000000000B00000000000000000000000000000000000000000000000000000000000004555555556
00000000000000000008887000000000007888000000000000000004555556000000000000000000000P0000000000T00000000000000000000000000000000000000000000000000000004555555556
0000000000000000008887700000000000778880000000000000000455555607777000000000000000888888881616888888880000000000000000000000000000000000000000000000A0004555555556
00000000E00P000008888770E0000000E077888800000000000000045555560T7770000000E009000088888888161688888888000000000000000000000000000000000000000000000000004555555556
122222222222222222222222222222222222222223161616161616122222345555562222222222222222230088888888161688888888000000000000000000000000000000000000000000000000004555555556
555555555555555555555555555555555555555556000000455555555555555555555555555555560088161616161616161616167777880000000000000000E00T0P000000000000000E0000000000004555555556
5555555555555555555555555555555555555555560000004555555555555555555555555555555600881616160000161616777788000122222222222222222222222222222222222222222300004555555556
5555555555555555555555555555555555555555560000004555555555555555555555555555555600881616160000161616777788000455555555555555555555555555555555555555555600004555555556
5555555555555555555555555555555555555555560000004555555555555555555555555555555600881616016E016161616777788000455555555555555555555555555555555555555555600004555555556
5555555555555555555555555555555555555555560000004555555555555555555555555555555600888888888888888888000455555555555555555555555555555555555555555600004555555556
5555555555555555555555555555555555555555560000004555555555555555555555555555555600888888888888888888000455555555555555555555555555555555555555555600004555555556
