129
45
50
../Super_Martin/sprites/tileSet_Forest.png
../Super_Martin/sprites/Background/green_hills_4.png
../Super_Martin/sound/ezer_ev.mp3
000000000000000000000000000000000000000000000000000000000000000000000000000000000000000000000000000000000000000000000000000000000
000000000000000000000000000000000000000000000000000000000000000000000000000000000000000000000000000000000000000000000000000000000
000000000000000000000000000000000000000000000000000000000000000000000000000000000000000000000000000000000000000000000000000000000
000000000000000000000000000000000000000000000000000000000000000000000000000000000000000000000000000000000000000000000000000000000
000000000000000000000000000000000000000000000000000000000000000000000000000000000000000000000000000000000000000000000000000000000
000000000000000000000000000000000000000000000000000000000000000000000000000000000000000000000000000000000000000000000000000000000
000000000000000000000000000000000000000000000000000000000000000000000000000000000000000000000000000000000000000000000000000000000
000000000000000000000000000000000000000000000000000000000000000000000000000000000000000000000000000000000000000000000000000000000
000000000000000000000000000000000000000000000000000000000000000000000000000000000000000000000000000000000000000000000000000000000
000000000000000000000000000000000000000000000000000000000000000000000000000000000000000000000000000000000000000000000000000000000
000000000000000000000000000000000000000000000000000000000000000000000000000000000000000000000000000000000000000000000000000000000
000000000000000000000000000000000000000000000000000000000000000000000000000000000000000000000000000000000000000000000000000000000
000000000000000000000000000000000000000000000000000000000000000000000000000000000000000000000000000000000000000000000000000000000
000000000000000000000000000000000000000000000000000000000000000000000000000000000000000000000000000000000000000000000000000000000
222222222222222222222222222222222222222222222222222222222222222222222222222222220000000000000000000000000000000000000000000000000
222222222222222222222222222222222222222222222222222222222222222222222222222222220000000000000000000001222222300000000000000000000
222222222222222222222222222222222222222222222222222222222222222222222222222222220000000000000000000004555555600000000000000000000
222222222222222222222222222222222222222222222222222222222222222222222222222222220000000000000000000004555555600000000000000000000
222222222222222222222222222222222222222222222222222222222222222222222222222222220000000000000000000004555555600000000000000000000
222222222222222222222222222222222222222222222222222222222222222222222222222222220000000000000000000004555555600000000000000000000
222222222222222222222222222222222222222222222222222222222222222222222222222222220000000000012223000004555555600000000000000000000
222222222222222222222222222222222222222222222222222222222222222222222222222222220000000000045556000004555555600000000000000000000
222222222222222222222222222222222222222222222222222222222222222222222222222222220000000000045556000004555555600000000000000000000
222222222222222222222222222222222222222222222222222222222222222222222222222222220000000000045556000004555555600000000000000000000
222222222222222222222222222222222222222222222222222222222222222222222222222222220000000000045556000004555555600000000000000000000
000000000000000000000000000000000000000000000000000000000000000000000000000000000000012223045556000004555555600000000000000000000
000000000000000000000000000000000000000000000000000000000000000000000000000000000000045556045556000004555555600000000000000000000
000000000000000000000000000000000000000000000000000000000000000000000000000000000000045556045556000004555555600000000888888888888
000000000000000000000000000000000000000000000000000000000000000000000000000000000000045556045556000004555555600000000000000000008
000000000000000000000000000000000000000000000000000000000000000000000000000000000000045556045556000004555555600000000000000000008
000000000000000000000000000000000000000000000000000000000000000001222222222222222223045556045556000004555555600000000000000000778
000000000000000000000000000000000000000000000000000000000000000004555555555555555556045556045556000004555555600000000000000000778
000000000000000000000000000000000000000000000000000000000000000004555555555555555556045556045556000004555555600000000000000000008
000000000001222222222222222222222222222222300000000000000000000004555555555555555556045556045556000004555555600000001222222222223
000000000004555555555555555555555555555555600012222222222222230004555555555555555556045556045556000004555555600000004555555555556
000000000004555555555555555555555555555555600045555555555555560004555555555555555556045556045556000004555555600000004555555555556
000000000004555555555555555555555555555555600045555555555555560004555555555555555556045556045556000004555555600000004555555555556
000000000004555555555555555555555555555555600045555555555555560004555555555555555556045556045556000004555555600000004555555555556
122222222225555555555555555555555555555555600045555555555555560004555555555555555556045556045556000004555555600000004555555555556
455555555555555555555555555555555555555555600045555555555555560004555555555555555556045556045556000004555555600000004555555555556
455555555555555555555555555555555555555555600045555555555555560004555555555555555556045556045556000004555555600000004555555555556
455555555555555555555555555555555555555555600045555555555555560004555555555555555556045556045556000004555555600000004555555555556
455555555555555555555555555555555555555555600045555555555555560004555555555555555556045556045556000004555555600000004555555555556
455555555555555555555555555555555555555555600045555555555555560004555555555555555556045556045556000004555555600000004555555555556
455555555555555555555555555555555555555555600045555555555555560004555555555555555556045556045556000004555555600000004555555555556
