100
45
50
../Super_Martin/sprites/tileSet_Snow.png
../Super_Martin/sprites/Background/green_hills_4.png
../Super_Martin/sound/ezer_ev.mp3
0000000000000000000000000000000000000000000000000000000000000000000000000000000000000000000000000000
0000000000000000000000000000000000000000000000000000000000000000000000000000000000000000000000000000
0000000000000000000000000000000000000000000000000000000000000000000000000000000000000000000000000000
0000000000000000000000000000000000000000000000000000000000000000000000000000000000000000000000000000
0000000000000000000000000000000000000000000000000000000000000000000000000000000000000000000000000000
0000000000000000000000000000000000000000000000000000000000000000000000000000000000000000000000000000
000000000000000000000000000000000000000000000000000N000000000000000000000000000000000000000000000000
00000000000000000000000000000000N000000000000000000000000000000000N000000000000000000000000000000000
00000000000N0000000000000000000000000000000000000000000000000000000000000000000000000000000000000000
0000000000000000000000000000000000000000000000000000000000000000000000000000000000000000000000000000
0000000000000000000000000000000000000000000000000000000000000000000000000000000000000000000000000000
0000000000000000000000000000000000000000000000000000000000000000000000000000000000000000000000000000
0000000000000000000000000000000000000000000000000000000000000000000000000000000000000000000000000000
00000000000000000000000000000000000000000000000000000000000000000000N0000000000000000000000000000000
000000000000000000000000000000000000000N000000000000000000000000000000000000000000000000000000000000
00000000000000000000N0000000000000000000000000000000000000000000000000000000000000000000000000000000
0000000000000000000000000000000000000000000000000000000000000000000000000000000000000000000000000000
0000000000000000000000000000000000000000000000000000000000000000000000000000000000000000000000000000
0000000000000000000000000000000000000000000000000000000000000000000000000000000000000000000000000002
0000000000000000000000000000000000000000000000000000000000000000000000000000000000000000000000000000
0222222222222222000000000000000000000000000000000000000000000000000000000000000000000000000000000000
0000000000000000000000000000000000000000000000000000000000000000000000000000000000000000000000000000
0000000000000000000000000000000000000000000000000000000000000000000000000000000000000000000000000000
0000000000000000000000000000000000000000000000000000000000000000000000000000000000000000000000000000
0000000000000000000000000000000000000000000000000000000000000000000000000000000000000000000000000000
0000000000000000000000000000000000000000000000000000000000000000000000000000000000000000000000000000
0000000000000000000000000000000000000000000000000000000000000000000000000000000000000000000000000000
0000000000000000000000000000000000000000000000000000000000000000000000000000000000000000000000000000
0000000000000000000000000000000000000000000000000000000000000000000000000000000000000000000000000000
0000000000000000000000000000000000000000000000000000000000000000000000000000000000000000000000000000
0000000000000000000000000000000000000000000000000000000000000000000000000000000000000000000000000000
0000000000000000000000000000000000000000000000000000000000000000000000000000000000000000000000000000
0000000000000000000000000008888800000000000000000000000000000000000000000000000000000000000000000000
0000000000000000000000000008000000000000000000000000000000000000000000000000000000000000000000000000
0000000000000000000000000008000000000000000000000000000000000000000000000000000000000000000000000000
00800000T00000P00000E00009080000008000000000T00P00900000000000000E000000T000000000000000E00000000000
2222222222222222222222222222222222222222002222222222000900000000000000022222222222222222222222222222
5555555555555555555555555555555555555555005555555555555555555555555555555555555555505555555555555555
5555555555555555555555555555555555555555005555555555555555555555555555555555555555555555555555555555
5555555555555555555555555555555555555555005555555555555525555555555555555555555555555555555555555555
5555555558555555555555555555555555555555085555555555555555555555555555555555555555555555555555555555
5555555555555555555555555555555555555555005555555555555555555555555555555555555555555555555555555555
5555555555555555555555555555555555555555005555555555555555555555555555555555555555555555555555555555
5555555555555555555555555555555555555555005555555555555555555555555855555555555555555555555555555555
5555555555555555555555555555555555555555555555555555555555555555555555555555555555555555555555555555
