159
34
50
../Super_Martin/sprites/tileSet_Beach.png
../Super_Martin/sprites/Background/green_hills_3.png
../Super_Martin/sound/ezer_ev.mp3
000000000000000000000000000000000000000000000000000000000000000000000000000000000000000000000000000000000000000000000000000000000000000000000000000000000000000
000000000000000000000000000000000000000000000000000000000000000000000000000000000000000000000000000000000000000000000000000000000000000000000000000000000000000
000000000000000000000000000000000000000000000000000000000000000000000000000000000000000000000000000000000000000000000000000000000000000000000000000000000000000
000000000000000000000000000000000000000000000000000000000000000000000000000000000000000000000000000000000000000000000000000000000000000000000000000000000000000
000000000000000000000000000000000000000000000000000000000000000000000000000000000000000000000000000000000000000000000000000000000000000000000000000000000000000
000000000000000000000000000000000000000000000000000000000000000000000000000000000000000000000000000000000000000000000000000000000000000000000000000000000000000
000000000000000000000000000000000000000000000000000000000000000000000000000000000000000000000000000000000000000000000000000000000000000000000000000000000000000
000000000000000000000000000000000000000000000000000000000000000000000000000000000000000000000000000000000000000000000000000000000000000000000000000000000000000
000000000000000000000000000000000000000000000000000000000000000000000000000000000000000000000000000004555555600000000000000000000000000000000000000000000000000
000000000000000000000000000000000000000000000000000000000000000000000000000000000000000000012223011104555555600000000000000000000000000000000000000000000000000
000000000000000000000000000000000000000000000000000000000000000000000000000000000000000000045556000004555555600000000000000000000000000000000000000000000000000
000000000000000000000000000000000000000000000000000000000000000000000000000000000000000000045556000004555555600000000000000000000000000000000000000000000000000
000000000000000000000000000000000000000000000000000000000000000000000000000000000000000000045556000004555555600000000000000000000000000000000000000000000000000
000000000000000000000000000000000000000000000000000000000000000000000000000000000000000000045556000004555555600000000000000000000000000000000000000000000000000
000000000000000000000000000000000000000000000000000000000000000000000000000000000000012223045556000004555555600000000000000000000000000000000000000000000000000
000000000000000000000000000000000000000000000000000000000000000000000000000000000000045556045556000004555555600000000000000000000000000000000000000000000000000
000000000000000000000000000000000000000000000000000000000000000000000000000000000000045556045556000004555555600000000888888888888888888888888888888888888888888
000000000000000000000000000000000000000000000000000000000000000000000000000000000000045556045556000004555555600000000000000000008888888888888888888888888888888
000000000000000000000000000000000000000000000000000000000000000000000000000000000000045556045556000004555555600000000000000000008888888888888888888888888888888
000000000000000070000000000000000000000000000000000000000000000001222222222222222223045556045556000004555555600000000000000000778888888888888888888888888888888
000000000000000000000000000000000000000000000000000000000000000004555555555555555556045556045556000004555555600000000000000000778888888888888888888888888888888
000000000000000000000000000000000000000000000000000000700000000004555555555555555556045556045556000004555555600000000000000000008888888888888888888888888888888
000000000001222222222222222222222222222222300000000000000000000004555555555555555556045556045556000004555555600000001222222222223333333333333333333333333333333
000000000004555555555555555555555555555555600012222222222222223004555555555555555556045556045556000004555555600000004555555555556666666666666666666666666666666
000000000004555555555555555555555555555555600045555555555555556004555555555555555556045556045556000004555555600000004555555555556666666666666666666666666666666
000000000004555555555555555555555555555555600045555555555555556004555555555555555556045556045556000004555555600000004555555555556666666666666666666666666666666
000070000004555555555555555555555555555555600045555555555555556004555555555555555556045556045556000004555555600000004555555555556666666666666666666666666666666
122222222225555555555555555555555555555555600045555555555555556004555555555555555556045556045556000004555555600000004555555555556666666666666666666666666666666
455555555555555555555555555555555555555555600045555555555555556004555555555555555556045556045556000004555555600000004555555555556666666666666666666666666666666
455555555555555555555555555555555555555555600045555555555555556004555555555555555556045556045556000004555555600000004555555555556666666666666666666666666666666
455555555555555555555555555555555555555555600045555555555555556004555555555555555556045556045556000004555555600000004555555555556666666666666666666666666666666
455555555555555555555555555555555555555555600045555555555555556004555555555555555556045556045556000004555555600000004555555555556666666666666666666666666666666
455555555555555555555555555555555555555555600045555555555555556004555555555555555556045556045556000004555555600000004555555555556666666666666666666666666666666
455555555555555555555555555555555555555555600045555555555555556004555555555555555556045556045556000004555555600000004555555555556666666666666666666666666666666
