100
50
50
../Super_Martin/sprites/tileSet_Mountains.png
../Super_Martin/sprites/Background/green_hills_4.png
../Super_Martin/sound/ezer_ev.mp3
0000000000000000000000000000000000000000000000000000000000000000000000000000000000000000000000000000
0000000000000000000000000000000000000000000000000000000000000000000000000000000000000000000000000000
0000000000000000000000000000000000000000000000000000000000000000000000000000000000000000000000000000
0000000000000000000000000000000000000000000000000000000000000000000000000000000000000000000000000000
0000000000000000000000000000000000000000000000000000000000000000000000000000000000000000000000000000
0000000000000000000000000000000000000000000000000000000000000000000000000000000000000000000000000000
0000000000000000000000000000000000000000000000000000000000000000000000000000000000000000000000000000
0000000000000000000000000000000000000000000000000000000000000000000000000000000000000000000000000000
0000000000000000000000000000000000000000000000000000000000000000000000000000000000000000000000000000
0000000000000000000000000000000000000000000000000000000000000000000000000000000000000000000000000000
0000000000000000000000000000000000000000000000000000000000000000000000000000000000000000000000000000
0000000000000000000000000000000000000000000000000000000000000000000000000000000000000000000000000000
0000000000000000000000000000000000000000000000000000000000000000000000000000000000000000000000000000
0000000000000000000000000000000000000000000000000000000000000000000000000000000000000000000000000000
0000000000000000000000000000000000000000000000000000000000000000000000000000000000000000000000000000
0000000000000000000000000000000000000000000000000000000000000000000000000000000000000000000000000000
0000000000000000000000000000000000000000000000000000000000000000000000000000000000000000000000000000
0000000000000000000000000000000000000000000000000000000000000000000000000000000000000000000000000000
0000000000000000000000000000000000000000000000000000000000000000000000000000000000000000000000000002
000000000T000000000000000000000000000000000000000000000000000000000000000000000000000000000000000000
0222222222222222000000T0000TT00000000000000000000000000000000000000000000000000000000000000000000000
00000000000000000000000T00T0000000000000000000000000000000000000000000000000000000000000000000000000
00000000000000000000000T00T0000000000000000000000000000000000000000000000000000000000000000000000000
000000000000000000000000T000000000000000000000000000000000000000000000000000000000000000000000000000
0000000000000000000000000TT0000000000000000000000000000000000000000000000000000000000000000000000000
0000000000000000000000000000000000000000000000000000000000000000000000000000000000000000000000000000
0000000000000000000000000000000000000000000000000000000000000000000000000000000000000000000000000000
0000000000000000000000000000000000000000000000000000000000000000000000000000000000000000000000000000
0000000000000000000000000000000000000000000000000000000000000000000000000000000000000000000000000000
0000000000000000000000000000000000000000000000000000000000000000000000000000000000000000000000000000
0000000000000000000000000000000000000000000000000000000000000000000000000000000000000000000000000000
0000000000000000000000000000000000000000000000000000000000000000000000000000000000000000000000000000
0000000000000000000000000008888800000000000000000000000000000000000000000000000000000000000000000000
0000000000000000000000000008000000000000000000000000000000000000000000000000000000000000000000000000
0000000000000000000000000T080000000000000000000000000000000000000T0000000000000000000000000000000000
008E000T000E000T0000E00000080000T0800000000000T000000000000000000E0000000000000000000000E00000000000
2222222222222222222222222222222222222E22002222222222000T00000000000000022222222222222222222222222222
5555555555555555555555555555555555555555005555555555555555555555555555555555555555505555555555555555
5555555555555555555555555555555555555555005555555555555555555555555555555555555555555555555555555555
5555555555555555555555555555555555555555005555555555555525555555555555555555555555555555555555555555
5555555558555555555555555555555555555555085555555555555555555555555555555555555555555555555555555555
5555555555555555555555555555555555555555005555555555555555555555555555555555555555555555555555555555
5555555555555555555555555555555555555555005555555555555555555555555555555555555555555555555555555555
5555555555555555555555555555555555555555005555555555555555555555555855555555555555555555555555555555
5555555555555555555555555555555555555555555555555555555555555555555555555555555555555555555555555555
行行行行行行行行行行行行行行行行行行行行行行行行行行行行行行行行行行行行行行行行行行行行行行行行行行
行行行行行行行行行行行行行行行行行行行行行行行行行行行行行行行行行行行行行行行行行行行行行行行行行行
行行行行行行行行行行行行行行行行行行行行行行行行行行行行行行行行行行行行行行行行行行行行行行行行行行
行行行行行行行行行行行行行行行行行行行行行行行行行行行行行行行行行行行行行行行行行行行行行行行行行行
行行行行行行行行行行行行行行行行行行行行行行行行行行行行行行行行行行行行行行行行行行行行行行行行行行
