72
45
50
../Super_Martin/sprites/tileSet_Snow.png
../Super_Martin/sprites/Background/green_hills_4.png
../Super_Martin/sound/ezer_ev.mp3
000000000000000000000000000000000000000000000000000000000000000000000000
000000000000000000000000000000000000000000000000000000000000000000000000
000000000000000000000000000000000000000000000000000000000000000000000000
000000000000000000000000000000000000000000000000N00000000000000000000000
000000000000N000000000000000000N000000000000000000000000000000000N000000
000000000000000000000000000000000000000000000000000000000000000000000000
000000000000000000000000000000000000000000000000000000000000000000000000
000000000000000000000000000000000000000000000000000000000000000000000000
00000000000000007777H777777777777777777770000777777777777777777000000000
000000000000000000000000000000000000000007777000000000000000000000000000
000000000000000000000000000000000000000000000000000000000000000000000000
000000000000000000000000000000000000000000000000000000000000000000N00000
0000000000000N0000000000000000000000000000000000000000000000000000000000
000000000000000000000000000000000000000000000000000000000000000000000000
000000000000000000000000000000000000000000000000000N00000000000000000000
000000000000000000000000000000000000000000000000000000000000000000000000
000000000000000000000000000000000000000000000000000000000000000000000000
0000000000000000B000000000000000B00000000B000000000000000000000B00000000
000000A00000000000000000000000000000000000000000000000000000000000000000
000000000000000000000000000000000000000000000000000000000000000000000000
000000000000000000000000000000000000000000000000000000000000000000000000
000000000000000000000000000000000000000000000000000000000000000000000000
000000000000000000000000000000000000000000000000000000000000000000000000
000000000000000000000000000000000000000000000000000000000000000000000000
000000000000000000000000000000000000000000000000000000000000000000000000
000000000000000000000000000000000000000000000000000000000000000000000000
000000000000000000000000000000000000000000000000000000000000000000000000
000000000000000000000000000000000000000000000077777700000000000000000000
000000000000000000000000000000000000000000000077777700000000000000000000
000000000000000000000000000000000000000000000000000000000000000000000000
000000000000000000000000000000000000000000000000000000000000000000000000
000000000000000000000000000000000000L00000000000000000000000000000000000
00000000000H0000000000000000000000000000000T000P00000E00T0000000000000E0
000000A00000000000000000000000000000000012222222222222222222222222222223
000000000000000000000000000000000000000045555555555555555555555555555556
0P0000000009000P000000T00000E0000900000045555555555555555555555555555556
122222222222222222222222222222222230000045555555555555555555555555555556
455555555555555555555555555555555560000045555555555555555555555555555556
455555555555555555555555555555555560000045555555555555555555555555555556
455555555555555555555555555555555560000045555555555555555555555555555556
455555555555555555555555555555555560000045555555555555555555555555555556
455555555555555555555555555555555560000045555555555555555555555555555556
455555555555555555555555555555555560000045555555555555555555555555555556
455555555555555555555555555555555560000045555555555555555555555555555556
455555555555555555555555555555555560000045555555555555555555555555555556
