100
45
50
../Super_Martin/sprites/tileSet_Snow.png
../Super_Martin/sprites/Background/blue_hills_1.png
../Super_Martin/sound/ezer_ev.mp3
0000000000000000000000000000000000000000000000000000000000000000000000000000000000000000000000000000
0000000000000000000000000000000000000000000000000000000000000000000000000000000000000000000000000000
0000000000000000000000000000000000000000000000000000000000000000000000000000000000000000000000000000
0000000000000000000000000000000000000000000000000000000000000000000000000000000000000000000000000000
0000000000000000000000000000000000000000000000000000000000000000000000000000000000000000000000000000
0000000000000000000000000000000000000000000000000000000000000000000000000000000000000000000000000000
0000000000000000000000000000000000000000000000000000000000000000000000000000000000000000000000000000
0000000000000000000000000000000000000000000000000000000000000000000000000000000000000000000000000000
0000000000000000000000000000000000000000000000000000000000000000000000000000000000000000000000000000
0000000000000000000000000000000000000000000000000000000000000000000000000000000000000000000000000000
0000000000000000000000000080000000000000000000000000000000000000000000000000000000000000000000000000
0000000000000000000000000080000000000000000000000000000000000000000000000000000000000000000000000000
0000000000000000000000000080000000000000000000000000000000000000000000000000000000000000000000000000
0000000000000000000000000080000000000000000000000000000000000000000000000000000000000000000000000000
0000000000000000000000000080000000000000000000000000000000000000000000000000000000000000000000000000
0000000000000000000000000080000000000000000000000000000000000000000000000000000000000000000000000000
0000000000000000000000000080000000000000000000000000000000000000000000000000000000000000000000000000
0000000000000000000000000080000000000000000000000000000000000000000000000000000000000000000000000000
0000000000000000000000000080000000000000000000000000000000000000000000000000000000000000000000000002
0000000000000000000000000080000000000000000000000000000000000000000000000000000000000000000000000000
0222222222222222000000000080000000000000000000000000000000000000000000000000000000000000000000000000
0000000000000000000000000080000000000000000000000000000000000000000000000000000000000000000000000000
0000000000000000000000000080000000000000000000000000000000000000000000000000000000000000000000000000
0000000000000000000000000080000000000000000000000000000000000000000000000000000000000000000000000000
0000000000000000000000000080000000000000000000000000000000000000000000000000000000000000000000000000
0000000000000000000000000080000000000000000000000000000000000000000000000000000000000000000000000000
0000000000000000000000000080000000000000000000000000000000000000000000000000000000000000000000000000
0000000000000000000000000080000000000000000000000000000000000000000000000000000000000000000000000000
0000000000000000000000000080000000000000000000000000000000000000000000000000000000000000000000000000
0000000000000000000000000080000000000000000000000000000000000000000000000000000000000000000000000000
0000000000000000000000000080000000000000000000000000000000000000000000000000000000000000000000000000
0000000000000000000000000080000000000000000000000000000000000000000000000000000000000000000000000000
0000000000000000000000000080000000000000000000000000000000000000000000000000000000000000000000000000
0000000000000000000000000080000000000000000000000000000000000000000000000000000000000000000000000000
0000000000000000000000000080000000000000000000000000000000000000000000000000000000000000000000000000
0080000000000000000000000080000000000000000000000000000000000000000000000000000000000000000000000000
2222222222222222222222222222222222222222002222222222000000000000000000022222222222222222222222222222
5555555555555555555555555555555555555555005555555555555555555555555555555555555555505555555555555555
5555555555555555555555555555555555555555005555555555555555555555555555555555555555555555555555555555
5555555555555555555555555555555555555555005555555555555525555555555555555555555555555555555555555555
5555555558555555555555555555555555555555085555555555555555555555555555555555555555555555555555555555
5555555555555555555555555555555555555555005555555555555555555555555555555555555555555555555555555555
5555555555555555555555555555555555555555005555555555555555555555555555555555555555555555555555555555
5555555555555555555555555555555555555555005555555555555555555555555855555555555555555555555555555555
5555555555555555555555555555555555555555555555555555555555555555555555555555555555555555555555555555
