158
34
50
sprites/Background/green_hills_3.png
sound/ezer_ev.mp3
00000000000000000000000000000000000000000000000000000000000000000000000000000000000000000000000000000000000000000000000000000000000000000000000000000000000000
00000000000000000000000000000000000000000000000000000000000000000000000000000000000000000000000000000000000000000000000000000000000000000000000000000000000000
00000000000000000000000000000000000000000000000000000000000000000000000000000000000000000000000000000000000000000000000000000000000000000000000000000000000000
00000000000000000000000000000000000000000000000000000000000000000000000000000000000000000000000000000000000000000000000000000000000000000000000000000000000000
00000000000000000000000000000000000000000000000000000000000000000000000000000000000000000000000000000122222230000000000000000000000000000000000000000000000000
00000000000000000000000000000000000000000000000000000000000000000000000000000000000000000000000000000455555560000000000000000000000000000000000000000000000000
00000000000000000000000000000000000000000000000000000000000000000000000000000000000000000000000000000455555560000000000000000000000000000000000000000000000000
00000000000000000000000000000000000000000000000000000000000000000000000000000000000000000000000000000455555560000000000000000000000000000000000000000000000000
00000000000000000000000000000000000000000000000000000000000000000000000000000000000000000000000000000455555560000000000000000000000000000000000000000000000000
00000000000000000000000000000000000000000000000000000000000000000000000000000000000000000000000000000455555560000000000000000000000000000000000000000000000000
00000000000000000000000000000000000000000000000000000000000000000000000000000000000000000000000000000455555560000000000000000000000000000000000000000000000000
00000000000000000000000000000000000000000000000000000000000000000000000000000000000000000000000000000455555560000000000000000000000000000000000000000000000000
00000000000000000000000000000000000000000000000000000000000000000000000000000000000000000000000000000455555560000000000000000000000000000000000000000000000000
00000000000000000000000000000000000000000000000000000000000000000000000000000000000000000000000000000455555560000000000000000000000000000000000000000000000000
00000000000000000000000000000000000000000000000000000000000000000000000000000000000000000000000000000455555560000000000000000000000000000000000000000000000000
00000000000000000000000000000000000000000000000000000000000000000000000000000000000000000000000000000455555560000000000000000000000000000000000000000000000000
00000000000000000000000000000000000000000000000000000000000000000000000000000000000000000000000000000455555560000000000000000000000000000000000000000000000000
00000000000000000000000000000000000000000000000000000000000000000000000000000000000000000000000000000455555560000000000000000000000000000000000000000000000000
00000000000000000000000000000000000000000000000000000000000000000000000000000000000000000000000000000455555560000000000000000000000000000000000000000000000000
00000000000000000000000000000000000000000000000000000000000000000000000000000000000000000000000000000000000000000000000000000000000000000000000000000000000000
00000000000000000000000000000000000000000000000000000000000000000000000000000000000000000000000000000000000000000000000000000000000000000000000000000000000000
00000000000000000000000000000000000000000000000000000000000000000000000000000000000000000000000000000000000000000000000000000000000000000000000000000000000000
00000000000000000000000000000000000000000000000000000000000000000000000000000000000000000000000000000000000000000000122222222222222222222222222222222222222222
00000000000000000000000000000000000000000000000000000000000000000000000000000000000000000000000000000455555560088800455555555555555555555555555555555555555555
00000000000000000000000000000000000000000000000000000000000000000000000000000000000000000000000000000455555560000000455555555555555555555555555555555555555555
00000000000000000000000000000000000000000000000000000000000000000000000000000000000000000001222308880455555560000000455555555555555555555555555555555555555555
00000000000000000000000000000000000000000000000000000000000000000000000000000000000000000004555600000455555560000000455555555555555555555555555555555555555555
12222222222222222222222222222222222222222222222222222222222222222222222222222222222301222304555600000455555560000000455555555555555555555555555555555555555555
45555555555555555555555555555555555555555555555555555555555555555555555555555555555604555604555600000455555560000000455555555555555555555555555555555555555555
45555555555555555555555555555555555555555555555555555555555555555555555555555555555604555604555600000455555560000000455555555555555555555555555555555555555555
45555555555555555555555555555555555555555555555555555555555555555555555555555555555604555604555600000455555560000000455555555555555555555555555555555555555555
45555555555555555555555555555555555555555555555555555555555555555555555555555555555604555604555600000455555560000000455555555555555555555555555555555555555555
45555555555555555555555555555555555555555555555555555555555555555555555555555555555604555604555600000455555560000000455555555555555555555555555555555555555555
45555555555555555555555555555555555555555555555555555555555555555555555555555555555604555604555600000455555560000000455555555555555555555555555555555555555555
