81
45
16
../Super_Martin/sprites/tileSet_Grassland.png
../Super_Martin/sprites/Background/green_hills_4.png
../Super_Martin/sound/ezer_ev.mp3
000000000000000000000000000000000000000000000000000000000000000000000000000000000
000000000000000000000000000000000000000000000000000000000000000000000000000000000
000000000000000000000000000000000000000000000000000000000000000000000000000000000
000000000000000000000000000000000000000000000000000000000000000000000000000000000
000000000000000000000000000000000000000000000000000000000000000000000000000000000
000000000000000000000000000000000000000000000000000000000000000000000000000000000
000000000000000000000000000000000000000000000000000000000000000000000000000000000
000000000000000000000000000000000000000000000000000000000000000000000000000000000
000000000000000000000000000000000000000000000000000000000000000000000000000000000
000000000000000000000000000000000000000000000000000000000000000000000000000000000
000000000000000000000000000000000000000000000000000000000000000000000000000000000
000000000000000000000000000000000000000000000000000000000000000000000000000000000
000000000000000000000000000000000000000000000000000000000000000000000000000000000
000000000000000000000000000000000000000000000000000000000000000000000000000000000
000000000000000000000000000000000000000000000000000000000000000000000000000000000
000000000000000000000000000000000000000000000000000000000000000000000000000000000
000000000000000000000000000000000000000000000000000000000000000000000000000000000
000000000000000000000000000000000000000000000000000000000000000000000000000000000
000000000000000000000000000000000000000000000000000000000000000000000000000000000
000000000000000000000000000000000000000000000000000000000000000000000000000000000
000000000000000000000000000000000000000000000000000000000000000000000000000000000
000000000000000000000000000000000000000000000000000000000000000000000000000000000
000000000000000000000000000000000000000000000000000000000000000000000000000000000
000000000000000000000000000000000000000000000000000000000000000000000000000000000
000000000000000000000000000000000000000000000000000000000000000000000000000000000
000000000000000000000000000000000000000000000000000000000000000000000000000000000
000000000000000000000000000000000000000000000000000000000000000000000000000000000
000000000000000000000000000000000000000000000000000000000000000000000000000000000
000000000000000000000000000000000000000000000000000000000000000000000000000000000
000000000000000000000000000000000000000000000000000000000000000000000000000000000
000000000000777770000000000000007000000000000000000000000000000000000000000000000
00000000000000000000000E000000007700000000000000000000000000000000000000000000000
022222222222222222222222222222222222222222222222222222222222222222222222222222222
055555555555555555555555555555555555555555555555555555555555555555555555555555555
055555555555555555555555555555555555555555555555555555555555555555555555555555555
055555555555555555555555555555555555555555555555555555555555555555555555555555555
055555555555555555555555555555555555555555555555555555555555555555555555555555555
055555555555555555555555555555555555555555555555555555555555555555555555555555555
055555555555555555555555555555555555555555555555555555555555555555555555555555555
055555555555555555555555555555555555555555555555555555555555555555555555555555555
055555555555555555555555555555555555555555555555555555555555555555555555555555555
055555555555555555555555555555555555555555555555555555555555555555555555555555555
055555555555555555555555555555555555555555555555555555555555555555555555555555555
055555555555555555555555555555555555555555555555555555555555555555555555555555555
055555555555555555555555555555555555555555555555555555555555555555555555555555555
