60
33
50
../Super_Martin/sprites/tileSet_Beach.png
../Super_Martin/sprites/tileSet_Beach.png
../Super_Martin/sprites/Background/green_hills_3.png
../Super_Martin/sound/ezer_ev.mp3
000000000000000000000000000000000000000000000000000000000000
000000000000000000000000000000000000000000000000000000000000
000000000000000000000000000000000000000000000000000000000000
000000000000000000000000000000000000000000000000000000000000
000000000000000000000000000000000000000000000000000000000000
000000000000000000000000000000000000000000000000000000000000
000000000000000000000000000000000000000000000000000000000000
000000000000000000000000000000000000000000000000000000000000
000000000000000000000000000000000000000000000000000000000000
000000000000000000000000000000000000000000000000000000000000
000000000000000000000000000000000000000000000000000000000000
000000000000000000000000000000000000000000000000000000000000
000000000000000000000000000000000000000000000000000000000000
000000000000000000000000000000000000000000000000000000000000
000000000000000000000000000000000000000000000000000000000000
000000000000000000000000000000000000000000000000000000000000
000000000000000000000000000000000000000000000000000000000000
000000000000000000000000000000000000000000000000000000000000
000000000000000000000000000000000000000000000000000000000000
000000000000000000000000000000000000000000000000000000000000
000000000000000000000000000000000000000000000000000000000000
222222222222222222222222222222000002222222222220330033333334
555555555555555555555555555555555555555555555555555555555555
222222222222222222222222222222222222222222222200000004550004
444444444444444444444444444444444444444445555555555555555004
000000000000000000002220000222222222222222220000000000400004
000000000000000000000000000000000000000000000000000000440004
000000000000000000000000000000000000000000000000000000004004
000000000000000000000000000000000000000000000000000000000404
000000000000000000000000000000000000000000000000000000000444
000000000000000000000000000000000000000000000000000000000044
000000000000000000000000000000000000000000000000000000000000
000000000000000000000000000000000000000000000000000000000000
