139
45
27
../Super_Martin/sprites/tileSet_Forest.png
../Super_Martin/sprites/Background/green_hills_4.png
../Super_Martin/sound/ezer_ev.mp3
0000000000000000000000000000000000000000000000000000000000000000000000000000000000000000000000000000000000000000000000000000000000000000000
0000000000000000000000000000000000000000000000000000000000000000000000000000000000000000000000000000000000000000000000000000000000000000000
0000000000000000000000000000000000000000000000000000000000000000000000000000000000000000000000000000000000000000000000000000000000000000000
0000000000000000000000000000000000000000000000000000000000000000000000000000000000000000000000000000000000000000000000000000000000000000000
0000000000000000000000000000000000000000000000000000000000000000000000000000000000000000000000000000000000000000000000000000000000000000000
0000000000000000000000000000000000000000000000000000000000000000000000000000000000000000000000000000000000000000000000000000000000000000000
0000000000000000000000000000000000000000000000000000000000000000000000000000000000000000000000000000000000000000000000000000000000000000000
0000000000000000000000000000000000000000000000000000000000000000000000000000000000000000000000000000000000000000000000000000000000000000000
0000000000000000000000000000000000000000000000000000000000000000000000000000000000000000000000000000000000000000000000000000000000000000000
0000000000000000000000000000000000000000000000000000000000000000000000000000000000000000000000000000000000000000000000000000000000000000000
0000000000000000000000000000000000000000000000000000000000000000000000000000000000000000000000000000000000000000000000000000000000000000000
0000000000000000000000000000000000000000000000000000000000000000000000000000000000000000000000000000000000000000000000000000000000000000000
0000000000000000000000000000000000000000000000000000000000000000000000000000000000000000000000000000000000000000000000000000000000000000000
0070000000000000000000000000000000000000000000000000000000000000000000000000000000000000000000000000000F00000000000000000000000000000000000
0077000000000000000000000000000000000000000000000000000000000000000000000000000000000000000000000000000000000000000000000000000000000000000
0077700000000000000000000000000000000000000000000000000000000000000000000000000000000000000000000000012222223000000000000000000000000000000
0077770000000000000000000000000000000000000000000000000000000000000000000000000000000000000000000000045555556000000000000000000000000000000
007777700000000000000000000000000000000000000000000000000000000000000000000000000000000000000C000000045555556000000000000000000000000000000
0077777770000000000000000000000000000000000000000000000000000000000000000000000000000000000000000000045555556000000000000000000000000000000
0000000000000000000000000000000000000000000000000000000000000000000000000000000000000000000000000000045555556000000000000000000000000000000
0000000000000000000000000000000000000000000000000000000000000000000000000000000000000000000122230000045555556000000000000000000000000000000
0000000000000000000000000000000000000000000000000000000000000000000000000000000000000000000455560000045555556000000000000000000000000000000
0000000000000000000000000000000000000000000000000000000000000000000000000000000000000000000455560000045555556000000000000000000000000000000
000B000000000000000000000000000000000000000000000000000000000000000000000000000000000000000455560000045555556000000000000000000000000000000
00000000000000000000000000000000000000000000000000000000000000000000000000000000000000000004555600000455555560000000000C0000000000000000000
0000000000000000000000000000000000000000000000000000000000000000000000000000000000000122230455560000045555556000000000000000000000000000000
000000000000000000000000000000000000000000000000000000000000000000000000000000000000045556045556000004555555600000000000000000E000000000000
0000000000000000000000000000000000000000000000000000000000000000000000000000000000000455560455560000045555556000000008888888888880000000000
0000000000000000000000000000000000000000000000000000000000000000000000000000F00000000455560455560000045555556000000000000000000080000000000
0000000000000000000000000C00000000000000000000000000000000000000000000000000000000000455560455560000045555556000000000000000000080000000000
0000000000000000000000000000000000000000000000000000000000000000012222222222222222230455560455560000045555556000A00000000000007780000000000
0000000000000000000000000000000000000F00000000000000000000000000045555555555555555560455560455560000045555556000000000000000007780000000000
00000000000000000000000000000000000000000000000000000F0000000000045555555555555555560455560455560000045555556000000000000000E00080000000000
00000000000122222222222222222222222222222230000000000000P0000000045555555555555555560455560455560000045555556000000012222222222230000000000
000C000000045555555555555555555555555555556000122222222222222300045555555555555555560455560455560000045555556000000045555555555560000000000
0000000000045555555555555555555555555555556000455555555555555600045555555555555555560455560455560000045555556000000045555555555560000000000
0000000000045555555555555555555555555555556000455555555555555600045555555555555555560455560455560000045555556000000045555555555560000700000
000000000004555555555555555555555555555555600045555555555555560004555555555555555556045556045556000004555555600000004555555555556000070G000
1222222222255555555555555555555555555555556000455555555555555600045555555555555555560455560455560000045555556000000045555555555560000000000
4555555555555555555555555555555555555555556000455555555555555600045555555555555555560455560455560000045555556000000045555555555560012222223
4555555555555555555555555555555555555555556000455555555555555600045555555555555555560455560455560000045555556000000045555555555560045555556
4555555555555555555555555555555555555555556000455555555555555600045555555555555555560455560455560000045555556000000045555555555560045555556
4555555555555555555555555555555555555555556000455555555555555600045555555555555555560455560455560000045555556000000045555555555560045555556
4555555555555555555555555555555555555555556000455555555555555600045555555555555555560455560455560000045555556000000045555555555560045555556
4555555555555555555555555555555555555555556000455555555555555600045555555555555555560455560455560000045555556000000045555555555560045555556
