416
45
83
../Super_Martin/sprites/tileSet_Snow.png
../Super_Martin/sprites/Background/blue_hills_1.png
../Super_Martin/sound/ezer_ev.mp3
00000000000000000000000000000000000000000000000000000000000000000000000000000000000000000000000000000000000000000000000000000000000000000000000000000000000000000000000000000000000000000000000000000000000000000000000000000000000000000000000000000000000000000000000000000000000000000000000000000000000000000000000000000000000000000000000000000000000000000000000000000000000000000000000000000000000000000000000000000000
00000000000000000000000000000000000000000000000000000000000000000000000000000000000000000000000000000000000000000000000000000000000000000000000000000000000000000000000000000000000000000000000000000000000000000000000000000000000000000000000000000000000000000000000000000000000000000000000000000000000000000000000000000000000000000000000000000000000000000000000000000000000000000000000000000000000000000000000000000000
00000000000000000000000777C77700000000000000000000000000000000000000000000000000000000000000000000000000000000000000000000000000000077777770000000000000000000000000000000000000000000000000000000000000000000000000000000000000000000000000000000000000000000000000000000000000000000000000000000000000000000000000000000000000000000000000000000000000000000000000000000000000000000000000000000000000000000000000000000000000
00000000000000000000000777C77700000000000000000000000000077700000000000000000000000000000000000000000000000000000000000A000000000000777L7770000000000000000000000000000000000000000000000000000000000000000000000000000000000000000000000000000000000000000000000000000000000000000000000000000000000000000000000000000000000000000000000000000000000000000000000000000000000000000000000000000000000000000000000000000000000000
0000000000000000000000000000000000000000000000000000000007H70000000000000000A0000000000000000C0000000000000000000000000000000000000077777770000000000000000000000000000000000000000000000000000000000000000000000000000000000000000000000000000000000000000000000000000000000000000000000000000000000000000000000000000000000000000000000000000000000000000000000000000000000000000000000000000000000000000000000000000000000000
00000000000000000000000000000000000000000000000000000000077700000000000000000000000000000000000000000000000000000000000000000000000000000000000000000000000000000000000000000000000000000000000000000000000000000000000000000000000000000000000000000000000000000000000000000000000000000000000000000000000000000000000000000000000000000000000000000000000000000000000000000000000000000000000000000000000000000000000000000000
00000000000000000000000000000000000000000000000000000000000000000000000000000000000000000000000000000000000000000000000000000000000000000000000000000000000000000000000000000000000000000000000000000000000000000000000000000000000000000000000000000000000007777000000000000000000000000000000077777700000000000000000000000000000000000000000000000000000000000000000000000000000000000000000000000000000000000000000000000000
00000000000000000000000000000000000000000000000000000000000000000000000000000000000000000000000000000000000000000000000000000000000000000000000000000000000000000000000000000000000000000000000000000000000000000000000000000000000000000000000000000000000007CH7000000000000000000000000000000077777700000000000000000000000000000000000777700000000000000000000000000000777777777000000000000000000000000000000000000000000000
00P000000000000000000000000000000000000000000000000000000000000000000000000000000000000000000000000000000000000000000000000000000000000000000000000000000000000000000000000000000000000000000000000000000000000000000000000000000000000000000000000000000000077770000000000000000000000000000000777777000000000000000000000000000000000007LC700000000000000000000000000000777777777000000000000000000000000000000000000000000000
1222222230000000000000000000000000000000000000000000000000000000000000000000000000000B0000000000000000B0000000000000000000000B0000000000000000000000B000000000000000000000000000000000000000000000000000000000000000000000000000000000000A00000000000000000000000000000000000000000000000000000000000000000000000000000000000000000000000777700000000000000000000000000000000000000000000000000000000000000000000000000000000000
45555555600B000000000000000000000000000B0000000000000000000000000000000000000000000000000000000000000000000000000000000000000000000000000000000000000000000000000000000000000000000000000000000000000000000000000000000000000000000000000000000000000000000000000000000000000000000000000000000000000000000000000000000000000000000000000000000000000000000000000000000000000000000000000000000000000000000000000000000000000000
45555555600000000000000000000000000000000000000000000000000000000000000000000000000000000000000000000000000000000000000000000000000000000000000000000000000000000000000000000000000000000000000000000000000000000000000000000000000000000000000000000000000000000000000000000000000000000000000000000000000000000000000000000000000000000000000000000000000000000000000000000000000000000000000000000000000000000000000000000000
4555555560000000000000000000000000000000000000000000000000000000000000000000A000000000000000000000000000000000000000000000000000000000000000000000000000000000000000000000000000000000000000000000000000000000000000000000000000000000000000000000000000000000000000000000000000000000000000000000000000000000000000000000000000000000000000000000000000000000000000000000000000000000000000000000000000000000000000000000000000
45555555600000000000000000000000000000000000000000000000000000000000000000000000000000000000000000000000000000000000000A00000000000000000000000000000000000000000000000000000000000000000000000000000000000000000000000000000000000000000000000000000000000000000000000000000000000000000000000000000000000000000000000000000000000000000000000000000000000000000000000000000000000000000000000000000000000000000000000000000000
455555556000000000000000000000000000000000000000000000000000000000000000000000000000000000000000000000000000000000000000000000000000000000000000000000000000000000000000000000000000000000000000000000000000000000000000000000000000000000000000000B000000000000000000000000B0000000B00000000000000000000000000000000B000000B0000000000000000000000000000B000000B000000000000000000000000000000B00000000000000000000000000000000
45555555600000000000000000000000000000000000B00000000000000000000000000B00000000000000000000000000000000000000000000000000000000000000000000000000000000000000000000000000000000000000000000000000000000000000000000000000000000000000000000000000000000000000000000000000000000000000000000000000000000000000000000000000000000000000000000000000000000000000000000000000000000000000000000000000000000000000000000000000000000
455555556000000000000000000000000000000000000000000000000000000000000000000000000000000000000000000000000000000D0000000000000000000000000000000000000000000000000000000000000000000000000000000000000000000000000777777700000000000000000000000000000000000000000000000000000000000000000000000000000000000000000000000000000000000000000000000000000000000000000000000000000000000000000000000000000000000000000000000000000000
4555555560000000000000000000000000000000000000000000000000000000000000000000000000000000000000000000000000000000P000000000000000000000000000000000000000000000000000000000000000000000000000000000000000000000000777777700000000000000000000000000000000000000000000000000000000000000000000000000000000000000000000000000000000000000000000000000000000000000000000000000000000000000000000000000000000000000000000000000000000
4555555560000000000000000000000000000000000000000000000000000000000000000000000000000000000000000000000001222222222300000000000000000000000000000000000000000D0000000000000000000000000000000000000000000000000000000000000000000000000000000000000000000000000000000000000000000000000000000000000000000000000000000000000000000000000000000000000000000000000000000000000000000000000000000000000000000000000000000F0000000000
45555555600000000000000000000000000000000000000000000000000000000000000000000000000000000000000000000000045555555556000000000000000000000000000000000000000000000000000000000000000000000000000000000000000000000000000000000000000000000A00000000000000000000000000000000000000000000000000000000000000000000000000000000000000000000000000000000000000000000000000000000000000000000000000000000000000000000000000000000000000
45555555600000000000000000000000000000000000000000000000000000000000000000000000000000000000000000000000045555555556000000000000000000000000000000000122222222222222223000000000000000000000000000000000000000000000000000000000000000000000000000000000000000000000000000000000000000000000000000000000000000000000000000000000000000000000000000000000000000000000000000000000000000000000000000000000000001222222222222222223
455555556000000000000000000000000000000000000000000000000000000000000000000000000000000000000000000000000455555555560000000000000000000000000000000004555555555555555560000000000000000000000000000000000000000000000000000000000E0000000000000000000000000000000000000000000000000000000000000000000000000000000000000000000000000000000000000000000000000000000000000000000000000000000000000000000000000004555555555555555556
45555555600000000000000000000000000000000000000000000000000000000000000000000000000000000000000000000000045555555556000000000000000000000000000000000455555555555555556000000000000000000000000000000122222222222222222222222222222300000000000000000000000000000000000000000000000000000000000000000000000000000000000000000000000000000000000000000000000000000000000000000000000000000000000000000000000004555555555555555556
45555555600000000000000000000000000000000000000000000000000000000000000000000000000000000000000000000000045555555556000000000000000000000000000000000455555555555555556000000000000000000000000000000455555555555555555555555555555600000000000000000000000000000000000000000000000000000000000000000000000000000000000000000000000000000000000000000000000000000000000000000000000000000000000000000000000004555555555555555556
45555555600000000000000000000000000000000000000000000000000000000000000000000000000000000000000000000000045555555556000000000000000000000000000000000455555555555555556000000000000000000000000000000455555555555555555555555555555600000000000000000000000000000000000000000000000000000000000000000000000000000000000000000000000000000000000000000000000000000000000000000000000000000000000000000000000004555555555555555556
45555555600000000000000000000000000000000000000000000000000000000000000000000000000000000000000000000000045555555556000000077700000000000000000000000455555555555555556000000000000000000000000000000455555555555555555555555555555600000000000000000000000000000000000000000000000000000000000000000000000000000000000000000000000000000000000000000000000000000000000000000000000000000000000000000000000004555555555555555556
4555555560000000000000000000000000000000000000000000000000000000000000000000000000000000000000000000000004555555555600000007770000000000000000000000045555555555555555600000000000000000000000000000045555555555555555555555555555560000000000000000000000000000000000000000000000000000000000000000000000000000000F000000000000000000000000000000000000000000000000000000000000000000000000000000000000000004555555555555555556
45555555600000000000000000000777000000000000000000000000000000000000000000000000000000000000000090000000045555555556000000000000000000000000000000000455555555555555556000000000000000000000000000000455555555555555555555555555555600000000000000000000000000000000000000000000000000000000000000000000000000T00000000000000000000000000000000000000000000000000000000000000000000000000000000000000000000004555555555555555556
455555556000000000000000000007770000000000000000000000000000000000000000000000012222222222222222230000000455555555560000000000000000000000000000000004555555555555555560000000000000000000000000000004555555555555555555555555555556000000000000000000000000000000000000000000000000000000000000000000012222222222222222222222223000000000000000000000000000000000000000000000000F0000000000000000000000000004555555555555555556
4555555560000000000000000000000000000000000F00000000000000000000000000000000000455555555555555555600000004555555555600000000000000000000000000000000045555555555555555600000000000000000000000000000045555555555555555555555555555560000000000000000000000000000000000000000000000000000000000000000000455555555555555555555555560000000000000000000000000000000000000000000000000000000000000E000000000900004555555555555555556
455555556000000000000000000000000000000000000000000000000000000000000000000000045555555555555555560000000455555555560000000000E000000P00000000900000045555555555555555600000000000000000000000000000045556000000000000000000004555560000000000000000000000000000000000000000000000000P00E000000000000004555555555555555555555555600000000000000000000077777000000000000000000000012222222222222222222222230004555555555555555556
45555555600000000000000000000000001222222222222223000000000000000000000000000004555555555555555556000000045555552222222222222222222222222222223000000455555555555555556000000000000000000000000000000455560000000077770000000045555600000000000000000000000000000000000000000122222222222222222230000004555555555555555555555555600000000000000000000077777000000000000000000000045555555555555555555555560004555555555555555556
45555555600000000000000000000000004555555555555556000B000000000000000000000B000455555555555555555600000004555555555555555555555555555555555555600000045555555555555555600000000000000000000000000000045556000000007HC70000000045555600000000000000000000000000000000000000000455555555555555555560000004555555555555555555555555600000000000000000000000000000000000000000000000045555555555555555555555560004555555555555555556
45555555600000000T0000E00000000000455555555555555600000000000000000000000000000455555555555555555600000004555555555555555555555555555555555555600000045555555555555555600P0000000E000000000000000000045556000000007777000000004555560000000000000000000000E00T000000000000000455555555555555555560000004555555555555555555555555600000000000000000000000000000000000000000000000045555555555555555555555560004555555555555555556
45555522222222222222222222230000004555555555555556000000000000000000000000000004555555555555555556000000045555555555555555555555555555555555556000000455555555555555222222222222222222230000000000000455560000000000000000000045555600000000001222222222222222222222223000000455555555555555555560000004555555555555555555555555600000000000000000000000000000000000000000000000045555555555555555555555560004555555555555555556
4555555555555555555555555556000000455555555555555600000000000000000000000000000455555555555555555600000004555555555555555555555555555555555555600000045555555555555555555555555555555556000000000000045556000000000000000000004555560000000000455555555555555555555555600000045555555555555555556000000455555555555555555555555560000000000000000000000000E000000000000090000000045555555555555555555555560004555555555555555556
45555555555555555555555555560000004555555555555556000000000000000000000000000004555555555555555556000000045555555555555555555555555555555555556000000455555555555555555555555555555555560000000000000000000000000000000000000000000000000000004555555555555555555555556000000455555555555555555560000004555555555555555555555555600000000122222222222222222222222222222230000000045555555555555555555555560004555555555555555556
45555555555555555555555555560000004555555555555556000000000000000000000000000004555555555555555556000000045555555555555555555555555555555555556000000455555555555555555555555555555555560000000000000000000000000000000000000000000000000000004555555555555555555555556000000455555555555555555560000004555555555555555555555555600000000455555555555555555555555555555560000000045555555555555555555555560004555555555555555556
45555555555555555555555555560000004555555555555556000000000000000000000000000004555555555555555556000000045555555555555555555555555555555555556000000455555555555555555555555555555555560000000000000000000000000000F00000000000000000000000004555555555555555555555556000000455555555555555555560000004555555555555555555555555600000000455555555555555555555555555555560000000045555555555555555555555560004555555555555555556
45555555555555555555555555560000004555555555555556000000000000000000000000000004555555555555555556000000045555555555555555555555555555555555556000000455555555555555555555555555555555560000000000000000000000P0000000000P000000000000090000004555555555555555555555556000000455555555555555555560000004555555555555555555555555600000000455555555555555555555555555555560000000045555555555555555555555560004555555555555555556
45555555555555555555555555560000004555555555555556000000000000000000000000000004555555555555555556000000045555555555555555555555555555555555556000000455555555555555555555555555555555560000000000122222222222222222222222222222222222230000004555555555555555555555556000000455555555555555555560000004555555555555555555555555600000000455555555555555555555555555555560000000045555555555555555555555560004555555555555555556
45555555555555555555555555560000004555555555555556000000000000000000000000000004555555555555555556000000045555555555555555555555555555555555556000000455555555555555555555555555555555560000000000455555555555555555555555555555555555560000004555555555555555555555556000000455555555555555555560000004555555555555555555555555600000000455555555555555555555555555555560000000045555555555555555555555560004555555555555555556
45555555555555555555555555560000004555555555555556000000000000000000000000000004555555555555555556000000045555555555555555555555555555555555556000000455555555555555555555555555555555560000000000455555555555555555555555555555555555560000004555555555555555555555556000000455555555555555555560000004555555555555555555555555600000000455555555555555555555555555555560000000045555555555555555555555560004555555555555555556
45555555555555555555555555560000004555555555555556000000000000000000000000000004555555555555555556000000045555555555555555555555555555555555556000000455555555555555555555555555555555560000000000455555555555555555555555555555555555560000004555555555555555555555556000000455555555555555555560000004555555555555555555555555600000000455555555555555555555555555555560000000045555555555555555555555560004555555555555555556
45555555555555555555555555560000004555555555555556000000000000000000000000000004555555555555555556000000045555555555555555555555555555555555556000000455555555555555555555555555555555560000000000455555555555555555555555555555555555560000004555555555555555555555556000000455555555555555555560000004555555555555555555555555600000000455555555555555555555555555555560000000045555555555555555555555560004555555555555555556
