81
45
16
../Super_Martin/sprites/tileSet_Desert.png
../Super_Martin/sprites/Background/green_hills_4.png
../Super_Martin/sound/ezer_ev.mp3
000000000000000000000000000000000000000000000000000000000000000000000000000000000
000000000000000000000000000000000000000000000000000000000000000000000000000000000
000000000000000000000000000000000000000000000000000000000000000000000000000000000
000000000000000000000000000000000000000000000000000000000000000000000000000000000
000000000000000000000000000000000000000000000000000000000000000000000000000000000
000000000000000000000000000000000000000000000000000000000000000000000000000000000
000000000000000000000000000000000000000000000000000000000000000000000000000000000
000000000000000000000000000000000000000000000000000000000000000000000000000000000
000000000000000000000000000000000000000000000000000000000000000000000000000000000
000000000000000000000000000000000000000000000000000000000000000000000000000000000
000000000000000000000000000000000000000000000000000000000000000000000000000000000
000000000000000000000000000000000000000000000000000000000000000000000000000000000
000000000000000000000000000000000000000000000000000000000000000000000000000000000
000000000000000000000000000000000000000000000007770000000000000000000000000000000
000000000000000000000000000000000000000000000007H70000000000000000000000000000000
000000000000000000000000000000000000000000000007770000000000000000000000000000000
000000000000000000000000000000000000000000000000000000000000000000000000000000000
000000000000000000000000000000000000000000000000000000000000000000000000000000000
000000000000000000000000000000000000000000000088888800000000000000000000000000000
000000000000000000000000000000000000000000000000000000000000000000000000000000000
000000007777700000000000000000000000000000000000000000000000000000000000000000000
000000000000700000000000000000000000000000000000000000000000000000000000000000000
000000000000700000000000000000000000000000000000000000000000000000000000000000000
000000000000000000000000000000000000000000000000000000000000000000000000000000000
000000000000000000000000B000000000000000B0000000000000000000000000000000000000000
122222300000000000000000000000000000000000000000000000000000000000000000000000000
000000000000000000000000000000000000000000000000000000000000000000000000000000000
00000000000000000000000000000000000000000000000000000000000000000000000000000D000
000000000000000000000000000000000000000000000000000000000000000000000000000000000
000000000000001222230000000000000000000000000000000000000000000000122222222222222
000000000000000000000000000000000000000000000000000000000000000000455555555555555
000000000000000000000000000000000000000000000000000000000000000888455555555555555
000000000000000000000000000000000000000000000000000000000000000800455555555555555
000000000000000000000000000000000000000000000000000000000000000000455555555555555
000000000000000000000000000000000000000000000000000000000000000000455555555555555
00000000000000000000000000000000000000000000F000000000000000000000455555555555555
000000000000T0000E0000000T00000000000E0000000000000000000000000000455555555555555
000000000122222222222222222222222222222222222222000000000000000000455555555555555
000000000455555555555555555555555555555555555555000000000000000000455555555555555
000000000455555555555555555555555555555555555555000000000000000000455555555555555
000000000455555555555555555555555555555555555555000000000E00090000455555555555555
000000000455555555555555555555555555555555555555000000122222223000455555555555555
000000000455555555555555555555555555555555555555000000455555556000455555555555555
000000000455555555555555555555555555555555555555000000455555556000455555555555555
000000000455555555555555555555555555555555555555000000455555556000455555555555555
