100
27
sprites/Background/green_hills_3.png
0000000000000000000000000000000000000000000000000000000000000000000000000000000000000000000000000000
0000000000000000000000000000000000000000000000000000000000000000000000000000000000000000000000000000
0000000000000000000000000000000000000000000000000000000000000000000000000000000000000000000000000000
0000000000000000000000000000000000000000000000000000000000000000000000000000000000000000000000000000
0000000000000000000000000000000000000000000000000000000000000000000000000000000000000000000000000000
0000000000000000000000000000000000000000000000000000000000000000000000000000000000000000000000000000
0000000000000000000000000000000000000000000000000000000000000000000000000000000000000000000000000000
0000000000000000000000000000000000000000000000000000000000000000000000000000000000000000000000000000
0000000000000000000000000000000000000000000000000000000000000000000000000000000000000000000000000000
0000000000000000000000000000000000000000000000000000000000000000000000000000000000000000000000000000
0000000000000000000000000000000000000000000000000000000000000000000000000000000000000000000000000000
0000000000000000000000000000000000000000000000000000000000000000000000000000000000000000000000000000
0000000000000000000000000000000000000000000000000000000000000000000000000000000000000000000000000000
0000000000000000000000000000000000000000000000000000000000000000000000000000000000000000000000000000
0000000000000000000000000000000000000000000000000000000000000000000000000000000000000000000000000000
0000000000000000000000000003333300000000000000000000000000000000000000000000000000000000000000000000
0000000000000000000000000003000000000000000000000000000000000000000000000000000000000000000000000000
0000000000000000000000000003000000000000000000000000000000000000000000000000000000000000000000000000
0030000000000000000000000003000000300000000000000000000000000000000000000000000000000000000000000000
1111111111111111110000011111111111111111001111111111111111111111111111111111111111111111111111111111
2222222222222222222222222222222222222222002222222222222222222222222222222222222222202222222222222222
2222222222222222222222222222222222222222002222222222222222222222222222222222222222222222222222222222
2222222222222222222222222222222222222222002222222222222212222222222222222222222222222222222222222222
2222222223222222222222222222222222222222002222222222222222222222222222222222222222222222222222222222
2222222222222222222222222222222222222222002222222222222222222222222222222222222222222222222222222222
2222222222222222222222222222222222222222002222222222222222222222222222222222222222222222222222222222
2222222222222222222222222222222222222222002222222222222222222222222322222222222222222222222222222222
