100
34
50
sprites/Background/green_hills_3.png
sound/ezer_ev.mp3
0000000000000000000000000000000000000000000000000000000000000000000000000000000000000000000000000000
0000000000000000000000000000000000000000000000000000000000000000000000000000000000000000000000000002
0000000000000000000000000000000000000000000000000000000000000000000000000000000000000000000000000000
0222222222222222000000000000000000000000000000000000000000000000000000000000000000000000000000000000
0000000000000000000000000000000000000000000000000000000000000000000000000000000000000000000000000000
0000000000000000000000000000000000000000000000000000000000000000000000000000000000000000000000000000
0000000000000000000000000000000000000000000000000000000000000000000000000000000000000000000000000000
0000000000000000000000000000000000000000000000000000000000000000000000000000000000000000000000000000
0000000000000000000000000000000000000000000000000000000000000000000000000000000000000000000000000000
0000000000000000000000000000000000000000000000000000000000000000000000000000000000000000000000000000
0000000000000000000000000000000000000000000000000000000000000000000000000000000000022222222200000000
0000000000000000000000000000000000000000000000000000000000000000000000000000222222222000000000000000
0000000000000000000000000000000000000000000000000000000000000000000000002222222220000000000000000000
0000000000000000000000000000000000000000000000000000000000000000002222222220000000000000000000000000
0000000000000000000000000000000000000000000000000000000000000222222222000000000000000000000000000000
0000000000000000000000000008888800000000000000000000000022222222200000000000000000000000000000000000
0000000000000000000000000008000000000000000000000222222222200000000000000000000000000000000000000000
0000000000000000000000000008000000000000000000000222222222200000000000000000000000000000000000000000
0080000000000000000000000008000000800000000000000222222222200000000000000000000000000000000000000000
2222222222222222220000022222222222222222002222222222222222222222222222222222222222222222222000000000
5555555555555555555555555555555555555555005555555555555555555555555555555555555555505555555000000000
5555555555555555555555555555555555555555005555555555555555555555555555555555555555555555555000000000
5555555555555555555555555555555555555555005555555555555525555555555555555555555555555555555000000000
5555555558555555555555555555555555555555085555555555555555555555555555555555555555555555555000000000
5555555555555555555555555555555555555555005555555555555555555555555555555555555555555555555000000000
5555555555555555555555555555555555555555005555555555555555555555555555555555555555555555555000000000
5555555555555555555555555555555555555555005555555555555555555555555855555555555555555555555555555555
5555555555555555555555555555555555555555555555555555555555555555555555555555555555555555555555555555
5555555555555555555555555555555555555555555555555555555555555555555555555555555555555555555555555555
5555555555555555555555555555555555555555555555555555555555555555555555555555555555555555555555555555
5555555555555555555555555555555555555555555555555555555555555555555555555555555555555555555555555555
5555555555555555555555555555555555555555555555555555555555555555555555555555555555555555555555555555
5555555555555555555555555555555555555555555555555555555555555555555555555555555555555555555555555555
5555555555555555555555555555555555555555555555555555555555555555555555555555555555555555555555555555
