100
27
10
sprites/Background/green_hills_3.png
sound/ezer_ev.mp3
0000000000000000000000000000000000000000000000000000000000000000000000000000000000000000000000000000
0000000000000000000000000000000000000000000000000000000000000000000000000000000000000000000000000001
0000000000000000000000000000000000000000000000000000000000000000000000000000000000000000000000000000
0111111111111111000000000000000000000000000000000000000000000000000000000000000000000000000000000000
0000000000000000000000000000000000000000000000000000000000000000000000000000000000000000000000000000
0000000000000000000000000000000000000000000000000000000000000000000000000000000000000000000000000000
0000000000000000000000000000000000000000000000000000000000000000000000000000000000000000000000000000
0000000000000000000000000000000000000000000000000000000000000000000000000000000000000000000000000000
0000000000000000000000000000000000000000000000000000000000000000000000000000000000000000000000000000
0000000000000000000000000000000000000000000000000000000000000000000000000000000000000000000000000000
0000000000000000000000000000000000000000000000000000000000000000000000000000000000000000000000000000
0000000000000000000000000000000000000000000000000000000000000000000000000000000000000000000000000000
0000000000000000000000000000000000000000000000000000000000000000000000000000000000000000000000000000
0000000000000000000000000000000000000000000000000000000000000000000000000000000000000000000000000000
0000000000000000000000000000000000000000000000000000000000000000000000000000000000000000000000000000
0000000000000000000000000003333300000000000000000000000000000000000000000000000000000000000000000000
0000000000000000000000000003000000000000000000000000000000000000000000000000000000000000000000000000
0000000000000000000000000003000000000000000000000000000000000000000000000000000000000000000000000000
0030000000000000000000000003000000300000000000000000000000000000000000000000000000000000000000000000
1111111111111111110000011111111111111111001111111111111111111111111111111111111111111111111111111111
2222222222222222222222222222222222222222002222222222222222222222222222222222222222202222222222222222
2222222222222222222222222222222222222222002222222222222222222222222222222222222222222222222222222222
2222222222222222222222222222222222222222002222222222222212222222222222222222222222222222222222222222
2222222223222222222222222222222222222222032222222222222222222222222222222222222222222222222222222222
2222222222222222222222222222222222222222002222222222222222222222222222222222222222222222222222222222
2222222222222222222222222222222222222222002222222222222222222222222222222222222222222222222222222222
2222222222222222222222222222222222222222002222222222222222222222222322222222222222222222222222222222
